Rank,teamId,league,teamImageId,teamFullName,team,teamAbbrevName,espnTeamId,G,W,L,T,Win%,G_Score1st,W_Score1st,L_Score1st,T_Score1st,Win%_Score1st,G_Allow1st,W_Allow1st,L_Allow1st,T_Allow1st,Win%_Allow1st,G,teamId,null,seasonId,scatterId,scatterExtra,season
1,610,NFL,610,Buffalo Bills,Buffalo Bills,BUF,8804,16,8,8,0,.500,10,7,3,0,.700,6,1,5,0,.167,16,610,,2000002,2000:610,2000,2000
1,2200,NFL,2200,Indianapolis Colts,Indianapolis Colts,IND,8813,16,10,6,0,.625,9,7,2,0,.778,7,3,4,0,.429,16,2200,,2000002,2000:2200,2000,2000
1,2310,NFL,2310,Kansas City Chiefs,Kansas City Chiefs,KC,8815,16,7,9,0,.438,4,3,1,0,.750,12,4,8,0,.333,16,2310,,2000002,2000:2310,2000,2000
1,4900,NFL,4900,Tampa Bay Buccaneers,Tampa Bay Buccaneers,TB,8829,16,10,6,0,.625,10,7,3,0,.700,6,3,3,0,.500,16,4900,,2000002,2000:4900,2000,2000
1,1800,NFL,1800,Green Bay Packers,Green Bay Packers,GB,8812,16,9,7,0,.563,9,7,2,0,.778,7,2,5,0,.286,16,1800,,2000002,2000:1800,2000,2000
1,3300,NFL,3300,New Orleans Saints,New Orleans Saints,NO,8819,16,10,6,0,.625,7,5,2,0,.714,9,5,4,0,.556,16,3300,,2000002,2000:3300,2000,2000
1,1050,NFL,1050,Cleveland Browns,Cleveland Browns,CLE,8808,16,3,13,0,.188,8,3,5,0,.375,8,0,8,0,.000,16,1050,,2000002,2000:1050,2000,2000
1,325,NFL,325,Baltimore Ravens,Baltimore Ravens,BAL,8803,16,12,4,0,.750,10,8,2,0,.800,6,4,2,0,.667,16,325,,2000002,2000:325,2000,2000
1,2510,NFL,2510,St. Louis Rams,St. Louis Rams,STL,8828,16,10,6,0,.625,7,4,3,0,.571,9,6,3,0,.667,16,2510,,2000002,2000:2510,2000,2000
1,3900,NFL,3900,Pittsburgh Steelers,Pittsburgh Steelers,PIT,8824,16,9,7,0,.563,6,5,1,0,.833,10,4,6,0,.400,16,3900,,2000002,2000:3900,2000,2000
1,810,NFL,810,Chicago Bears,Chicago Bears,CHI,8806,16,5,11,0,.313,6,4,2,0,.667,10,1,9,0,.100,16,810,,2000002,2000:810,2000,2000
1,2100,NFL,2100,Tennessee Titans,Tennessee Titans,TEN,8830,16,13,3,0,.813,8,8,0,0,1.000,8,5,3,0,.625,16,2100,,2000002,2000:2100,2000,2000
1,5110,NFL,5110,Washington Redskins,Washington Redskins,WAS,8831,16,8,8,0,.500,10,6,4,0,.600,6,2,4,0,.333,16,5110,,2000002,2000:5110,2000,2000
1,4600,NFL,4600,Seattle Seahawks,Seattle Seahawks,SEA,8827,16,6,10,0,.375,11,5,6,0,.455,5,1,4,0,.200,16,4600,,2000002,2000:4600,2000,2000
1,4500,NFL,4500,San Francisco 49ers,San Francisco 49ers,SF,8826,16,6,10,0,.375,9,5,4,0,.556,7,1,6,0,.143,16,4500,,2000002,2000:4500,2000,2000
1,3800,NFL,3800,Arizona Cardinals,Arizona Cardinals,ARI,8801,16,3,13,0,.188,3,2,1,0,.667,13,1,12,0,.077,16,3800,,2000002,2000:3800,2000,2000
1,2250,NFL,2250,Jacksonville Jaguars,Jacksonville Jaguars,JAC,8814,16,7,9,0,.438,11,5,6,0,.455,5,2,3,0,.400,16,2250,,2000002,2000:2250,2000,2000
1,1400,NFL,1400,Denver Broncos,Denver Broncos,DEN,8810,16,11,5,0,.688,10,8,2,0,.800,6,3,3,0,.500,16,1400,,2000002,2000:1400,2000,2000
1,2520,NFL,2520,Oakland Raiders,Oakland Raiders,OAK,8822,16,12,4,0,.750,8,8,0,0,1.000,8,4,4,0,.500,16,2520,,2000002,2000:2520,2000,2000
1,200,NFL,200,Atlanta Falcons,Atlanta Falcons,ATL,8802,16,4,12,0,.250,6,2,4,0,.333,10,2,8,0,.200,16,200,,2000002,2000:200,2000,2000
1,3700,NFL,3700,Philadelphia Eagles,Philadelphia Eagles,PHI,8823,16,11,5,0,.688,9,7,2,0,.778,7,4,3,0,.571,16,3700,,2000002,2000:3700,2000,2000
1,1200,NFL,1200,Dallas Cowboys,Dallas Cowboys,DAL,8809,16,5,11,0,.313,6,2,4,0,.333,10,3,7,0,.300,16,1200,,2000002,2000:1200,2000,2000
1,3410,NFL,3410,New York Giants,New York Giants,NYG,8820,16,12,4,0,.750,10,10,0,0,1.000,6,2,4,0,.333,16,3410,,2000002,2000:3410,2000,2000
1,3200,NFL,3200,New England Patriots,New England Patriots,NE,8818,16,5,11,0,.313,9,5,4,0,.556,7,0,7,0,.000,16,3200,,2000002,2000:3200,2000,2000
1,3430,NFL,3430,New York Jets,New York Jets,NYJ,8821,16,9,7,0,.563,6,4,2,0,.667,10,5,5,0,.500,16,3430,,2000002,2000:3430,2000,2000
1,4400,NFL,4400,San Diego Chargers,San Diego Chargers,SD,8825,16,1,15,0,.063,6,0,6,0,.000,10,1,9,0,.100,16,4400,,2000002,2000:4400,2000,2000
1,1540,NFL,1540,Detroit Lions,Detroit Lions,DET,8811,16,9,7,0,.563,9,6,3,0,.667,7,3,4,0,.429,16,1540,,2000002,2000:1540,2000,2000
1,3000,NFL,3000,Minnesota Vikings,Minnesota Vikings,MIN,8817,16,11,5,0,.688,8,7,1,0,.875,8,4,4,0,.500,16,3000,,2000002,2000:3000,2000,2000
1,920,NFL,920,Cincinnati Bengals,Cincinnati Bengals,CIN,8807,16,4,12,0,.250,4,2,2,0,.500,12,2,10,0,.167,16,920,,2000002,2000:920,2000,2000
1,750,NFL,750,Carolina Panthers,Carolina Panthers,CAR,8805,16,7,9,0,.438,10,6,4,0,.600,6,1,5,0,.167,16,750,,2000002,2000:750,2000,2000
1,2700,NFL,2700,Miami Dolphins,Miami Dolphins,MIA,8816,16,11,5,0,.688,9,7,2,0,.778,7,4,3,0,.571,16,2700,,2000002,2000:2700,2000,2000
32,610,NFL,610,Buffalo Bills,Buffalo Bills,BUF,8804,16,3,13,0,.188,3,1,2,0,.333,13,2,11,0,.154,16,610,,2001002,2001:610,2001,2001
32,2200,NFL,2200,Indianapolis Colts,Indianapolis Colts,IND,8813,16,6,10,0,.375,7,4,3,0,.571,9,2,7,0,.222,16,2200,,2001002,2001:2200,2001,2001
32,2310,NFL,2310,Kansas City Chiefs,Kansas City Chiefs,KC,8815,16,6,10,0,.375,8,5,3,0,.625,8,1,7,0,.125,16,2310,,2001002,2001:2310,2001,2001
32,4900,NFL,4900,Tampa Bay Buccaneers,Tampa Bay Buccaneers,TB,8829,16,9,7,0,.563,11,7,4,0,.636,5,2,3,0,.400,16,4900,,2001002,2001:4900,2001,2001
32,1800,NFL,1800,Green Bay Packers,Green Bay Packers,GB,8812,16,12,4,0,.750,7,7,0,0,1.000,9,5,4,0,.556,16,1800,,2001002,2001:1800,2001,2001
32,3300,NFL,3300,New Orleans Saints,New Orleans Saints,NO,8819,16,7,9,0,.438,5,2,3,0,.400,11,5,6,0,.455,16,3300,,2001002,2001:3300,2001,2001
32,1050,NFL,1050,Cleveland Browns,Cleveland Browns,CLE,8808,16,7,9,0,.438,10,6,4,0,.600,6,1,5,0,.167,16,1050,,2001002,2001:1050,2001,2001
32,325,NFL,325,Baltimore Ravens,Baltimore Ravens,BAL,8803,16,10,6,0,.625,7,5,2,0,.714,9,5,4,0,.556,16,325,,2001002,2001:325,2001,2001
32,2510,NFL,2510,St. Louis Rams,St. Louis Rams,STL,8828,16,14,2,0,.875,13,11,2,0,.846,3,3,0,0,1.000,16,2510,,2001002,2001:2510,2001,2001
32,3900,NFL,3900,Pittsburgh Steelers,Pittsburgh Steelers,PIT,8824,16,13,3,0,.813,12,9,3,0,.750,4,4,0,0,1.000,16,3900,,2001002,2001:3900,2001,2001
32,810,NFL,810,Chicago Bears,Chicago Bears,CHI,8806,16,13,3,0,.813,10,8,2,0,.800,6,5,1,0,.833,16,810,,2001002,2001:810,2001,2001
32,2100,NFL,2100,Tennessee Titans,Tennessee Titans,TEN,8830,16,7,9,0,.438,11,7,4,0,.636,5,0,5,0,.000,16,2100,,2001002,2001:2100,2001,2001
32,5110,NFL,5110,Washington Redskins,Washington Redskins,WAS,8831,16,8,8,0,.500,6,4,2,0,.667,10,4,6,0,.400,16,5110,,2001002,2001:5110,2001,2001
32,4600,NFL,4600,Seattle Seahawks,Seattle Seahawks,SEA,8827,16,9,7,0,.563,7,6,1,0,.857,9,3,6,0,.333,16,4600,,2001002,2001:4600,2001,2001
32,4500,NFL,4500,San Francisco 49ers,San Francisco 49ers,SF,8826,16,12,4,0,.750,5,4,1,0,.800,11,8,3,0,.727,16,4500,,2001002,2001:4500,2001,2001
32,3800,NFL,3800,Arizona Cardinals,Arizona Cardinals,ARI,8801,16,7,9,0,.438,7,3,4,0,.429,9,4,5,0,.444,16,3800,,2001002,2001:3800,2001,2001
32,2250,NFL,2250,Jacksonville Jaguars,Jacksonville Jaguars,JAC,8814,16,6,10,0,.375,6,4,2,0,.667,10,2,8,0,.200,16,2250,,2001002,2001:2250,2001,2001
32,1400,NFL,1400,Denver Broncos,Denver Broncos,DEN,8810,16,8,8,0,.500,8,5,3,0,.625,8,3,5,0,.375,16,1400,,2001002,2001:1400,2001,2001
32,2520,NFL,2520,Oakland Raiders,Oakland Raiders,OAK,8822,16,10,6,0,.625,11,8,3,0,.727,5,2,3,0,.400,16,2520,,2001002,2001:2520,2001,2001
32,200,NFL,200,Atlanta Falcons,Atlanta Falcons,ATL,8802,16,7,9,0,.438,11,6,5,0,.545,5,1,4,0,.200,16,200,,2001002,2001:200,2001,2001
32,3700,NFL,3700,Philadelphia Eagles,Philadelphia Eagles,PHI,8823,16,11,5,0,.688,8,7,1,0,.875,8,4,4,0,.500,16,3700,,2001002,2001:3700,2001,2001
32,1200,NFL,1200,Dallas Cowboys,Dallas Cowboys,DAL,8809,16,5,11,0,.313,8,3,5,0,.375,8,2,6,0,.250,16,1200,,2001002,2001:1200,2001,2001
32,3410,NFL,3410,New York Giants,New York Giants,NYG,8820,16,7,9,0,.438,7,4,3,0,.571,9,3,6,0,.333,16,3410,,2001002,2001:3410,2001,2001
32,3200,NFL,3200,New England Patriots,New England Patriots,NE,8818,16,11,5,0,.688,13,9,4,0,.692,3,2,1,0,.667,16,3200,,2001002,2001:3200,2001,2001
32,3430,NFL,3430,New York Jets,New York Jets,NYJ,8821,16,10,6,0,.625,10,6,4,0,.600,6,4,2,0,.667,16,3430,,2001002,2001:3430,2001,2001
32,4400,NFL,4400,San Diego Chargers,San Diego Chargers,SD,8825,16,5,11,0,.313,8,5,3,0,.625,8,0,8,0,.000,16,4400,,2001002,2001:4400,2001,2001
32,1540,NFL,1540,Detroit Lions,Detroit Lions,DET,8811,16,2,14,0,.125,3,1,2,0,.333,13,1,12,0,.077,16,1540,,2001002,2001:1540,2001,2001
32,3000,NFL,3000,Minnesota Vikings,Minnesota Vikings,MIN,8817,16,5,11,0,.313,7,3,4,0,.429,9,2,7,0,.222,16,3000,,2001002,2001:3000,2001,2001
32,920,NFL,920,Cincinnati Bengals,Cincinnati Bengals,CIN,8807,16,6,10,0,.375,4,2,2,0,.500,12,4,8,0,.333,16,920,,2001002,2001:920,2001,2001
32,750,NFL,750,Carolina Panthers,Carolina Panthers,CAR,8805,16,1,15,0,.063,8,1,7,0,.125,8,0,8,0,.000,16,750,,2001002,2001:750,2001,2001
32,2700,NFL,2700,Miami Dolphins,Miami Dolphins,MIA,8816,16,11,5,0,.688,7,6,1,0,.857,9,5,4,0,.556,16,2700,,2001002,2001:2700,2001,2001
63,610,NFL,610,Buffalo Bills,Buffalo Bills,BUF,8804,16,8,8,0,.500,5,3,2,0,.600,11,5,6,0,.455,16,610,,2002002,2002:610,2002,2002
63,2200,NFL,2200,Indianapolis Colts,Indianapolis Colts,IND,8813,16,10,6,0,.625,6,6,0,0,1.000,10,4,6,0,.400,16,2200,,2002002,2002:2200,2002,2002
63,2310,NFL,2310,Kansas City Chiefs,Kansas City Chiefs,KC,8815,16,8,8,0,.500,9,5,4,0,.556,7,3,4,0,.429,16,2310,,2002002,2002:2310,2002,2002
63,4900,NFL,4900,Tampa Bay Buccaneers,Tampa Bay Buccaneers,TB,8829,16,12,4,0,.750,9,8,1,0,.889,7,4,3,0,.571,16,4900,,2002002,2002:4900,2002,2002
63,1800,NFL,1800,Green Bay Packers,Green Bay Packers,GB,8812,16,12,4,0,.750,8,7,1,0,.875,8,5,3,0,.625,16,1800,,2002002,2002:1800,2002,2002
63,3300,NFL,3300,New Orleans Saints,New Orleans Saints,NO,8819,16,9,7,0,.563,11,6,5,0,.545,5,3,2,0,.600,16,3300,,2002002,2002:3300,2002,2002
63,1050,NFL,1050,Cleveland Browns,Cleveland Browns,CLE,8808,16,9,7,0,.563,10,5,5,0,.500,6,4,2,0,.667,16,1050,,2002002,2002:1050,2002,2002
63,325,NFL,325,Baltimore Ravens,Baltimore Ravens,BAL,8803,16,7,9,0,.438,7,5,2,0,.714,9,2,7,0,.222,16,325,,2002002,2002:325,2002,2002
63,2510,NFL,2510,St. Louis Rams,St. Louis Rams,STL,8828,16,7,9,0,.438,9,6,3,0,.667,7,1,6,0,.143,16,2510,,2002002,2002:2510,2002,2002
63,3900,NFL,3900,Pittsburgh Steelers,Pittsburgh Steelers,PIT,8824,16,10,5,1,.656,10,8,1,1,.850,6,2,4,0,.333,16,3900,,2002002,2002:3900,2002,2002
63,810,NFL,810,Chicago Bears,Chicago Bears,CHI,8806,16,4,12,0,.250,8,2,6,0,.250,8,2,6,0,.250,16,810,,2002002,2002:810,2002,2002
63,2100,NFL,2100,Tennessee Titans,Tennessee Titans,TEN,8830,16,11,5,0,.688,9,8,1,0,.889,7,3,4,0,.429,16,2100,,2002002,2002:2100,2002,2002
63,5110,NFL,5110,Washington Redskins,Washington Redskins,WAS,8831,16,7,9,0,.438,7,5,2,0,.714,9,2,7,0,.222,16,5110,,2002002,2002:5110,2002,2002
63,4600,NFL,4600,Seattle Seahawks,Seattle Seahawks,SEA,8827,16,7,9,0,.438,10,6,4,0,.600,6,1,5,0,.167,16,4600,,2002002,2002:4600,2002,2002
63,4500,NFL,4500,San Francisco 49ers,San Francisco 49ers,SF,8826,16,10,6,0,.625,8,5,3,0,.625,8,5,3,0,.625,16,4500,,2002002,2002:4500,2002,2002
63,3800,NFL,3800,Arizona Cardinals,Arizona Cardinals,ARI,8801,16,5,11,0,.313,4,2,2,0,.500,12,3,9,0,.250,16,3800,,2002002,2002:3800,2002,2002
63,2250,NFL,2250,Jacksonville Jaguars,Jacksonville Jaguars,JAC,8814,16,6,10,0,.375,8,4,4,0,.500,8,2,6,0,.250,16,2250,,2002002,2002:2250,2002,2002
63,2120,NFL,2120,Houston Texans,Houston Texans,HOU,13974,16,4,12,0,.250,7,3,4,0,.429,9,1,8,0,.111,16,2120,,2002002,2002:2120,2002,2002
63,1400,NFL,1400,Denver Broncos,Denver Broncos,DEN,8810,16,9,7,0,.563,11,7,4,0,.636,5,2,3,0,.400,16,1400,,2002002,2002:1400,2002,2002
63,2520,NFL,2520,Oakland Raiders,Oakland Raiders,OAK,8822,16,11,5,0,.688,11,10,1,0,.909,5,1,4,0,.200,16,2520,,2002002,2002:2520,2002,2002
63,200,NFL,200,Atlanta Falcons,Atlanta Falcons,ATL,8802,16,9,6,1,.594,8,6,2,0,.750,8,3,4,1,.438,16,200,,2002002,2002:200,2002,2002
63,3700,NFL,3700,Philadelphia Eagles,Philadelphia Eagles,PHI,8823,16,12,4,0,.750,10,8,2,0,.800,6,4,2,0,.667,16,3700,,2002002,2002:3700,2002,2002
63,1200,NFL,1200,Dallas Cowboys,Dallas Cowboys,DAL,8809,16,5,11,0,.313,4,2,2,0,.500,12,3,9,0,.250,16,1200,,2002002,2002:1200,2002,2002
63,3410,NFL,3410,New York Giants,New York Giants,NYG,8820,16,10,6,0,.625,11,8,3,0,.727,5,2,3,0,.400,16,3410,,2002002,2002:3410,2002,2002
63,3200,NFL,3200,New England Patriots,New England Patriots,NE,8818,16,9,7,0,.563,9,6,3,0,.667,7,3,4,0,.429,16,3200,,2002002,2002:3200,2002,2002
63,3430,NFL,3430,New York Jets,New York Jets,NYJ,8821,16,9,7,0,.563,7,6,1,0,.857,9,3,6,0,.333,16,3430,,2002002,2002:3430,2002,2002
63,4400,NFL,4400,San Diego Chargers,San Diego Chargers,SD,8825,16,8,8,0,.500,6,5,1,0,.833,10,3,7,0,.300,16,4400,,2002002,2002:4400,2002,2002
63,1540,NFL,1540,Detroit Lions,Detroit Lions,DET,8811,16,3,13,0,.188,6,2,4,0,.333,10,1,9,0,.100,16,1540,,2002002,2002:1540,2002,2002
63,3000,NFL,3000,Minnesota Vikings,Minnesota Vikings,MIN,8817,16,6,10,0,.375,7,2,5,0,.286,9,4,5,0,.444,16,3000,,2002002,2002:3000,2002,2002
63,920,NFL,920,Cincinnati Bengals,Cincinnati Bengals,CIN,8807,16,2,14,0,.125,5,0,5,0,.000,11,2,9,0,.182,16,920,,2002002,2002:920,2002,2002
63,750,NFL,750,Carolina Panthers,Carolina Panthers,CAR,8805,16,7,9,0,.438,3,1,2,0,.333,13,6,7,0,.462,16,750,,2002002,2002:750,2002,2002
63,2700,NFL,2700,Miami Dolphins,Miami Dolphins,MIA,8816,16,9,7,0,.563,13,8,5,0,.615,3,1,2,0,.333,16,2700,,2002002,2002:2700,2002,2002
95,610,NFL,610,Buffalo Bills,Buffalo Bills,BUF,8804,16,6,10,0,.375,8,5,3,0,.625,8,1,7,0,.125,16,610,,2003002,2003:610,2003,2003
95,2200,NFL,2200,Indianapolis Colts,Indianapolis Colts,IND,8813,16,12,4,0,.750,9,7,2,0,.778,7,5,2,0,.714,16,2200,,2003002,2003:2200,2003,2003
95,2310,NFL,2310,Kansas City Chiefs,Kansas City Chiefs,KC,8815,16,13,3,0,.813,8,8,0,0,1.000,8,5,3,0,.625,16,2310,,2003002,2003:2310,2003,2003
95,4900,NFL,4900,Tampa Bay Buccaneers,Tampa Bay Buccaneers,TB,8829,16,7,9,0,.438,6,5,1,0,.833,10,2,8,0,.200,16,4900,,2003002,2003:4900,2003,2003
95,1800,NFL,1800,Green Bay Packers,Green Bay Packers,GB,8812,16,10,6,0,.625,12,9,3,0,.750,4,1,3,0,.250,16,1800,,2003002,2003:1800,2003,2003
95,3300,NFL,3300,New Orleans Saints,New Orleans Saints,NO,8819,16,8,8,0,.500,9,6,3,0,.667,7,2,5,0,.286,16,3300,,2003002,2003:3300,2003,2003
95,1050,NFL,1050,Cleveland Browns,Cleveland Browns,CLE,8808,16,5,11,0,.313,6,2,4,0,.333,10,3,7,0,.300,16,1050,,2003002,2003:1050,2003,2003
95,325,NFL,325,Baltimore Ravens,Baltimore Ravens,BAL,8803,16,10,6,0,.625,6,5,1,0,.833,10,5,5,0,.500,16,325,,2003002,2003:325,2003,2003
95,2510,NFL,2510,St. Louis Rams,St. Louis Rams,STL,8828,16,12,4,0,.750,10,9,1,0,.900,6,3,3,0,.500,16,2510,,2003002,2003:2510,2003,2003
95,3900,NFL,3900,Pittsburgh Steelers,Pittsburgh Steelers,PIT,8824,16,6,10,0,.375,7,4,3,0,.571,9,2,7,0,.222,16,3900,,2003002,2003:3900,2003,2003
95,810,NFL,810,Chicago Bears,Chicago Bears,CHI,8806,16,7,9,0,.438,6,4,2,0,.667,10,3,7,0,.300,16,810,,2003002,2003:810,2003,2003
95,2100,NFL,2100,Tennessee Titans,Tennessee Titans,TEN,8830,16,12,4,0,.750,12,9,3,0,.750,4,3,1,0,.750,16,2100,,2003002,2003:2100,2003,2003
95,5110,NFL,5110,Washington Redskins,Washington Redskins,WAS,8831,16,5,11,0,.313,8,4,4,0,.500,8,1,7,0,.125,16,5110,,2003002,2003:5110,2003,2003
95,4600,NFL,4600,Seattle Seahawks,Seattle Seahawks,SEA,8827,16,10,6,0,.625,10,7,3,0,.700,6,3,3,0,.500,16,4600,,2003002,2003:4600,2003,2003
95,4500,NFL,4500,San Francisco 49ers,San Francisco 49ers,SF,8826,16,7,9,0,.438,11,7,4,0,.636,5,0,5,0,.000,16,4500,,2003002,2003:4500,2003,2003
95,3800,NFL,3800,Arizona Cardinals,Arizona Cardinals,ARI,8801,16,4,12,0,.250,5,3,2,0,.600,11,1,10,0,.091,16,3800,,2003002,2003:3800,2003,2003
95,2250,NFL,2250,Jacksonville Jaguars,Jacksonville Jaguars,JAC,8814,16,5,11,0,.313,5,3,2,0,.600,11,2,9,0,.182,16,2250,,2003002,2003:2250,2003,2003
95,2120,NFL,2120,Houston Texans,Houston Texans,HOU,13974,16,5,11,0,.313,5,2,3,0,.400,11,3,8,0,.273,16,2120,,2003002,2003:2120,2003,2003
95,1400,NFL,1400,Denver Broncos,Denver Broncos,DEN,8810,16,10,6,0,.625,10,6,4,0,.600,6,4,2,0,.667,16,1400,,2003002,2003:1400,2003,2003
95,2520,NFL,2520,Oakland Raiders,Oakland Raiders,OAK,8822,16,4,12,0,.250,9,4,5,0,.444,7,0,7,0,.000,16,2520,,2003002,2003:2520,2003,2003
95,200,NFL,200,Atlanta Falcons,Atlanta Falcons,ATL,8802,16,5,11,0,.313,11,5,6,0,.455,5,0,5,0,.000,16,200,,2003002,2003:200,2003,2003
95,3700,NFL,3700,Philadelphia Eagles,Philadelphia Eagles,PHI,8823,16,12,4,0,.750,7,7,0,0,1.000,9,5,4,0,.556,16,3700,,2003002,2003:3700,2003,2003
95,1200,NFL,1200,Dallas Cowboys,Dallas Cowboys,DAL,8809,16,10,6,0,.625,7,6,1,0,.857,9,4,5,0,.444,16,1200,,2003002,2003:1200,2003,2003
95,3410,NFL,3410,New York Giants,New York Giants,NYG,8820,16,4,12,0,.250,2,0,2,0,.000,14,4,10,0,.286,16,3410,,2003002,2003:3410,2003,2003
95,3200,NFL,3200,New England Patriots,New England Patriots,NE,8818,16,14,2,0,.875,10,10,0,0,1.000,6,4,2,0,.667,16,3200,,2003002,2003:3200,2003,2003
95,3430,NFL,3430,New York Jets,New York Jets,NYJ,8821,16,6,10,0,.375,8,2,6,0,.250,8,4,4,0,.500,16,3430,,2003002,2003:3430,2003,2003
95,4400,NFL,4400,San Diego Chargers,San Diego Chargers,SD,8825,16,4,12,0,.250,5,4,1,0,.800,11,0,11,0,.000,16,4400,,2003002,2003:4400,2003,2003
95,1540,NFL,1540,Detroit Lions,Detroit Lions,DET,8811,16,5,11,0,.313,7,4,3,0,.571,9,1,8,0,.111,16,1540,,2003002,2003:1540,2003,2003
95,3000,NFL,3000,Minnesota Vikings,Minnesota Vikings,MIN,8817,16,9,7,0,.563,8,7,1,0,.875,8,2,6,0,.250,16,3000,,2003002,2003:3000,2003,2003
95,920,NFL,920,Cincinnati Bengals,Cincinnati Bengals,CIN,8807,16,8,8,0,.500,7,5,2,0,.714,9,3,6,0,.333,16,920,,2003002,2003:920,2003,2003
95,750,NFL,750,Carolina Panthers,Carolina Panthers,CAR,8805,16,11,5,0,.688,12,10,2,0,.833,4,1,3,0,.250,16,750,,2003002,2003:750,2003,2003
95,2700,NFL,2700,Miami Dolphins,Miami Dolphins,MIA,8816,16,10,6,0,.625,10,9,1,0,.900,6,1,5,0,.167,16,2700,,2003002,2003:2700,2003,2003
127,610,NFL,610,Buffalo Bills,Buffalo Bills,BUF,8804,16,9,7,0,.563,9,7,2,0,.778,7,2,5,0,.286,16,610,,2004002,2004:610,2004,2004
127,2200,NFL,2200,Indianapolis Colts,Indianapolis Colts,IND,8813,16,12,4,0,.750,12,10,2,0,.833,4,2,2,0,.500,16,2200,,2004002,2004:2200,2004,2004
127,2310,NFL,2310,Kansas City Chiefs,Kansas City Chiefs,KC,8815,16,7,9,0,.438,6,1,5,0,.167,10,6,4,0,.600,16,2310,,2004002,2004:2310,2004,2004
127,4900,NFL,4900,Tampa Bay Buccaneers,Tampa Bay Buccaneers,TB,8829,16,5,11,0,.313,5,4,1,0,.800,11,1,10,0,.091,16,4900,,2004002,2004:4900,2004,2004
127,1800,NFL,1800,Green Bay Packers,Green Bay Packers,GB,8812,16,10,6,0,.625,8,6,2,0,.750,8,4,4,0,.500,16,1800,,2004002,2004:1800,2004,2004
127,3300,NFL,3300,New Orleans Saints,New Orleans Saints,NO,8819,16,8,8,0,.500,2,2,0,0,1.000,14,6,8,0,.429,16,3300,,2004002,2004:3300,2004,2004
127,1050,NFL,1050,Cleveland Browns,Cleveland Browns,CLE,8808,16,4,12,0,.250,7,3,4,0,.429,9,1,8,0,.111,16,1050,,2004002,2004:1050,2004,2004
127,325,NFL,325,Baltimore Ravens,Baltimore Ravens,BAL,8803,16,9,7,0,.563,5,3,2,0,.600,11,6,5,0,.545,16,325,,2004002,2004:325,2004,2004
127,2510,NFL,2510,St. Louis Rams,St. Louis Rams,STL,8828,16,8,8,0,.500,8,6,2,0,.750,8,2,6,0,.250,16,2510,,2004002,2004:2510,2004,2004
127,3900,NFL,3900,Pittsburgh Steelers,Pittsburgh Steelers,PIT,8824,16,15,1,0,.938,10,10,0,0,1.000,6,5,1,0,.833,16,3900,,2004002,2004:3900,2004,2004
127,810,NFL,810,Chicago Bears,Chicago Bears,CHI,8806,16,5,11,0,.313,5,2,3,0,.400,11,3,8,0,.273,16,810,,2004002,2004:810,2004,2004
127,2100,NFL,2100,Tennessee Titans,Tennessee Titans,TEN,8830,16,5,11,0,.313,10,4,6,0,.400,6,1,5,0,.167,16,2100,,2004002,2004:2100,2004,2004
127,5110,NFL,5110,Washington Redskins,Washington Redskins,WAS,8831,16,6,10,0,.375,12,6,6,0,.500,4,0,4,0,.000,16,5110,,2004002,2004:5110,2004,2004
127,4600,NFL,4600,Seattle Seahawks,Seattle Seahawks,SEA,8827,16,9,7,0,.563,7,5,2,0,.714,9,4,5,0,.444,16,4600,,2004002,2004:4600,2004,2004
127,4500,NFL,4500,San Francisco 49ers,San Francisco 49ers,SF,8826,16,2,14,0,.125,6,1,5,0,.167,10,1,9,0,.100,16,4500,,2004002,2004:4500,2004,2004
127,3800,NFL,3800,Arizona Cardinals,Arizona Cardinals,ARI,8801,16,6,10,0,.375,7,4,3,0,.571,9,2,7,0,.222,16,3800,,2004002,2004:3800,2004,2004
127,2250,NFL,2250,Jacksonville Jaguars,Jacksonville Jaguars,JAC,8814,16,9,7,0,.563,6,6,0,0,1.000,10,3,7,0,.300,16,2250,,2004002,2004:2250,2004,2004
127,2120,NFL,2120,Houston Texans,Houston Texans,HOU,13974,16,7,9,0,.438,6,5,1,0,.833,10,2,8,0,.200,16,2120,,2004002,2004:2120,2004,2004
127,1400,NFL,1400,Denver Broncos,Denver Broncos,DEN,8810,16,10,6,0,.625,8,6,2,0,.750,8,4,4,0,.500,16,1400,,2004002,2004:1400,2004,2004
127,2520,NFL,2520,Oakland Raiders,Oakland Raiders,OAK,8822,16,5,11,0,.313,9,3,6,0,.333,7,2,5,0,.286,16,2520,,2004002,2004:2520,2004,2004
127,200,NFL,200,Atlanta Falcons,Atlanta Falcons,ATL,8802,16,11,5,0,.688,12,9,3,0,.750,4,2,2,0,.500,16,200,,2004002,2004:200,2004,2004
127,3700,NFL,3700,Philadelphia Eagles,Philadelphia Eagles,PHI,8823,16,13,3,0,.813,8,8,0,0,1.000,8,5,3,0,.625,16,3700,,2004002,2004:3700,2004,2004
127,1200,NFL,1200,Dallas Cowboys,Dallas Cowboys,DAL,8809,16,6,10,0,.375,9,3,6,0,.333,7,3,4,0,.429,16,1200,,2004002,2004:1200,2004,2004
127,3410,NFL,3410,New York Giants,New York Giants,NYG,8820,16,6,10,0,.375,8,3,5,0,.375,8,3,5,0,.375,16,3410,,2004002,2004:3410,2004,2004
127,3200,NFL,3200,New England Patriots,New England Patriots,NE,8818,16,14,2,0,.875,15,13,2,0,.867,1,1,0,0,1.000,16,3200,,2004002,2004:3200,2004,2004
127,3430,NFL,3430,New York Jets,New York Jets,NYJ,8821,16,10,6,0,.625,9,7,2,0,.778,7,3,4,0,.429,16,3430,,2004002,2004:3430,2004,2004
127,4400,NFL,4400,San Diego Chargers,San Diego Chargers,SD,8825,16,12,4,0,.750,11,10,1,0,.909,5,2,3,0,.400,16,4400,,2004002,2004:4400,2004,2004
127,1540,NFL,1540,Detroit Lions,Detroit Lions,DET,8811,16,6,10,0,.375,7,3,4,0,.429,9,3,6,0,.333,16,1540,,2004002,2004:1540,2004,2004
127,3000,NFL,3000,Minnesota Vikings,Minnesota Vikings,MIN,8817,16,8,8,0,.500,6,3,3,0,.500,10,5,5,0,.500,16,3000,,2004002,2004:3000,2004,2004
127,920,NFL,920,Cincinnati Bengals,Cincinnati Bengals,CIN,8807,16,8,8,0,.500,9,5,4,0,.556,7,3,4,0,.429,16,920,,2004002,2004:920,2004,2004
127,750,NFL,750,Carolina Panthers,Carolina Panthers,CAR,8805,16,7,9,0,.438,7,5,2,0,.714,9,2,7,0,.222,16,750,,2004002,2004:750,2004,2004
127,2700,NFL,2700,Miami Dolphins,Miami Dolphins,MIA,8816,16,4,12,0,.250,7,3,4,0,.429,9,1,8,0,.111,16,2700,,2004002,2004:2700,2004,2004
159,610,NFL,610,Buffalo Bills,Buffalo Bills,BUF,8804,16,5,11,0,.313,11,4,7,0,.364,5,1,4,0,.200,16,610,,2005002,2005:610,2005,2005
159,2200,NFL,2200,Indianapolis Colts,Indianapolis Colts,IND,8813,16,14,2,0,.875,13,12,1,0,.923,3,2,1,0,.667,16,2200,,2005002,2005:2200,2005,2005
159,2310,NFL,2310,Kansas City Chiefs,Kansas City Chiefs,KC,8815,16,10,6,0,.625,12,8,4,0,.667,4,2,2,0,.500,16,2310,,2005002,2005:2310,2005,2005
159,4900,NFL,4900,Tampa Bay Buccaneers,Tampa Bay Buccaneers,TB,8829,16,11,5,0,.688,10,9,1,0,.900,6,2,4,0,.333,16,4900,,2005002,2005:4900,2005,2005
159,1800,NFL,1800,Green Bay Packers,Green Bay Packers,GB,8812,16,4,12,0,.250,5,2,3,0,.400,11,2,9,0,.182,16,1800,,2005002,2005:1800,2005,2005
159,3300,NFL,3300,New Orleans Saints,New Orleans Saints,NO,8819,16,3,13,0,.188,5,1,4,0,.200,11,2,9,0,.182,16,3300,,2005002,2005:3300,2005,2005
159,1050,NFL,1050,Cleveland Browns,Cleveland Browns,CLE,8808,16,6,10,0,.375,7,3,4,0,.429,9,3,6,0,.333,16,1050,,2005002,2005:1050,2005,2005
159,325,NFL,325,Baltimore Ravens,Baltimore Ravens,BAL,8803,16,6,10,0,.375,8,4,4,0,.500,8,2,6,0,.250,16,325,,2005002,2005:325,2005,2005
159,2510,NFL,2510,St. Louis Rams,St. Louis Rams,STL,8828,16,6,10,0,.375,8,2,6,0,.250,8,4,4,0,.500,16,2510,,2005002,2005:2510,2005,2005
159,3900,NFL,3900,Pittsburgh Steelers,Pittsburgh Steelers,PIT,8824,16,11,5,0,.688,9,8,1,0,.889,7,3,4,0,.429,16,3900,,2005002,2005:3900,2005,2005
159,810,NFL,810,Chicago Bears,Chicago Bears,CHI,8806,16,11,5,0,.688,7,6,1,0,.857,9,5,4,0,.556,16,810,,2005002,2005:810,2005,2005
159,2100,NFL,2100,Tennessee Titans,Tennessee Titans,TEN,8830,16,4,12,0,.250,9,3,6,0,.333,7,1,6,0,.143,16,2100,,2005002,2005:2100,2005,2005
159,5110,NFL,5110,Washington Redskins,Washington Redskins,WAS,8831,16,10,6,0,.625,8,6,2,0,.750,8,4,4,0,.500,16,5110,,2005002,2005:5110,2005,2005
159,4600,NFL,4600,Seattle Seahawks,Seattle Seahawks,SEA,8827,16,13,3,0,.813,8,7,1,0,.875,8,6,2,0,.750,16,4600,,2005002,2005:4600,2005,2005
159,4500,NFL,4500,San Francisco 49ers,San Francisco 49ers,SF,8826,16,4,12,0,.250,6,2,4,0,.333,10,2,8,0,.200,16,4500,,2005002,2005:4500,2005,2005
159,3800,NFL,3800,Arizona Cardinals,Arizona Cardinals,ARI,8801,16,5,11,0,.313,6,2,4,0,.333,10,3,7,0,.300,16,3800,,2005002,2005:3800,2005,2005
159,2250,NFL,2250,Jacksonville Jaguars,Jacksonville Jaguars,JAC,8814,16,12,4,0,.750,9,8,1,0,.889,7,4,3,0,.571,16,2250,,2005002,2005:2250,2005,2005
159,2120,NFL,2120,Houston Texans,Houston Texans,HOU,13974,16,2,14,0,.125,6,1,5,0,.167,10,1,9,0,.100,16,2120,,2005002,2005:2120,2005,2005
159,1400,NFL,1400,Denver Broncos,Denver Broncos,DEN,8810,16,13,3,0,.813,12,10,2,0,.833,4,3,1,0,.750,16,1400,,2005002,2005:1400,2005,2005
159,2520,NFL,2520,Oakland Raiders,Oakland Raiders,OAK,8822,16,4,12,0,.250,7,2,5,0,.286,9,2,7,0,.222,16,2520,,2005002,2005:2520,2005,2005
159,200,NFL,200,Atlanta Falcons,Atlanta Falcons,ATL,8802,16,8,8,0,.500,10,7,3,0,.700,6,1,5,0,.167,16,200,,2005002,2005:200,2005,2005
159,3700,NFL,3700,Philadelphia Eagles,Philadelphia Eagles,PHI,8823,16,6,10,0,.375,6,3,3,0,.500,10,3,7,0,.300,16,3700,,2005002,2005:3700,2005,2005
159,1200,NFL,1200,Dallas Cowboys,Dallas Cowboys,DAL,8809,16,9,7,0,.563,5,2,3,0,.400,11,7,4,0,.636,16,1200,,2005002,2005:1200,2005,2005
159,3410,NFL,3410,New York Giants,New York Giants,NYG,8820,16,11,5,0,.688,11,9,2,0,.818,5,2,3,0,.400,16,3410,,2005002,2005:3410,2005,2005
159,3200,NFL,3200,New England Patriots,New England Patriots,NE,8818,16,10,6,0,.625,9,7,2,0,.778,7,3,4,0,.429,16,3200,,2005002,2005:3200,2005,2005
159,3430,NFL,3430,New York Jets,New York Jets,NYJ,8821,16,4,12,0,.250,3,2,1,0,.667,13,2,11,0,.154,16,3430,,2005002,2005:3430,2005,2005
159,4400,NFL,4400,San Diego Chargers,San Diego Chargers,SD,8825,16,9,7,0,.563,8,6,2,0,.750,8,3,5,0,.375,16,4400,,2005002,2005:4400,2005,2005
159,1540,NFL,1540,Detroit Lions,Detroit Lions,DET,8811,16,5,11,0,.313,7,4,3,0,.571,9,1,8,0,.111,16,1540,,2005002,2005:1540,2005,2005
159,3000,NFL,3000,Minnesota Vikings,Minnesota Vikings,MIN,8817,16,9,7,0,.563,8,5,3,0,.625,8,4,4,0,.500,16,3000,,2005002,2005:3000,2005,2005
159,920,NFL,920,Cincinnati Bengals,Cincinnati Bengals,CIN,8807,16,11,5,0,.688,7,6,1,0,.857,9,5,4,0,.556,16,920,,2005002,2005:920,2005,2005
159,750,NFL,750,Carolina Panthers,Carolina Panthers,CAR,8805,16,11,5,0,.688,10,9,1,0,.900,6,2,4,0,.333,16,750,,2005002,2005:750,2005,2005
159,2700,NFL,2700,Miami Dolphins,Miami Dolphins,MIA,8816,16,9,7,0,.563,6,5,1,0,.833,10,4,6,0,.400,16,2700,,2005002,2005:2700,2005,2005
191,610,NFL,610,Buffalo Bills,Buffalo Bills,BUF,8804,16,7,9,0,.438,10,6,4,0,.600,6,1,5,0,.167,16,610,,2006002,2006:610,2006,2006
191,2200,NFL,2200,Indianapolis Colts,Indianapolis Colts,IND,8813,16,12,4,0,.750,10,8,2,0,.800,6,4,2,0,.667,16,2200,,2006002,2006:2200,2006,2006
191,2310,NFL,2310,Kansas City Chiefs,Kansas City Chiefs,KC,8815,16,9,7,0,.563,9,7,2,0,.778,7,2,5,0,.286,16,2310,,2006002,2006:2310,2006,2006
191,4900,NFL,4900,Tampa Bay Buccaneers,Tampa Bay Buccaneers,TB,8829,16,4,12,0,.250,7,3,4,0,.429,9,1,8,0,.111,16,4900,,2006002,2006:4900,2006,2006
191,1800,NFL,1800,Green Bay Packers,Green Bay Packers,GB,8812,16,8,8,0,.500,8,5,3,0,.625,8,3,5,0,.375,16,1800,,2006002,2006:1800,2006,2006
191,3300,NFL,3300,New Orleans Saints,New Orleans Saints,NO,8819,16,10,6,0,.625,6,5,1,0,.833,10,5,5,0,.500,16,3300,,2006002,2006:3300,2006,2006
191,1050,NFL,1050,Cleveland Browns,Cleveland Browns,CLE,8808,16,4,12,0,.250,6,2,4,0,.333,10,2,8,0,.200,16,1050,,2006002,2006:1050,2006,2006
191,325,NFL,325,Baltimore Ravens,Baltimore Ravens,BAL,8803,16,13,3,0,.813,10,9,1,0,.900,6,4,2,0,.667,16,325,,2006002,2006:325,2006,2006
191,2510,NFL,2510,St. Louis Rams,St. Louis Rams,STL,8828,16,8,8,0,.500,9,6,3,0,.667,7,2,5,0,.286,16,2510,,2006002,2006:2510,2006,2006
191,3900,NFL,3900,Pittsburgh Steelers,Pittsburgh Steelers,PIT,8824,16,8,8,0,.500,9,7,2,0,.778,7,1,6,0,.143,16,3900,,2006002,2006:3900,2006,2006
191,810,NFL,810,Chicago Bears,Chicago Bears,CHI,8806,16,13,3,0,.813,9,8,1,0,.889,7,5,2,0,.714,16,810,,2006002,2006:810,2006,2006
191,2100,NFL,2100,Tennessee Titans,Tennessee Titans,TEN,8830,16,8,8,0,.500,9,5,4,0,.556,7,3,4,0,.429,16,2100,,2006002,2006:2100,2006,2006
191,5110,NFL,5110,Washington Redskins,Washington Redskins,WAS,8831,16,5,11,0,.313,6,2,4,0,.333,10,3,7,0,.300,16,5110,,2006002,2006:5110,2006,2006
191,4600,NFL,4600,Seattle Seahawks,Seattle Seahawks,SEA,8827,16,9,7,0,.563,6,4,2,0,.667,10,5,5,0,.500,16,4600,,2006002,2006:4600,2006,2006
191,4500,NFL,4500,San Francisco 49ers,San Francisco 49ers,SF,8826,16,7,9,0,.438,8,4,4,0,.500,8,3,5,0,.375,16,4500,,2006002,2006:4500,2006,2006
191,3800,NFL,3800,Arizona Cardinals,Arizona Cardinals,ARI,8801,16,5,11,0,.313,8,3,5,0,.375,8,2,6,0,.250,16,3800,,2006002,2006:3800,2006,2006
191,2250,NFL,2250,Jacksonville Jaguars,Jacksonville Jaguars,JAC,8814,16,8,8,0,.500,7,5,2,0,.714,9,3,6,0,.333,16,2250,,2006002,2006:2250,2006,2006
191,2120,NFL,2120,Houston Texans,Houston Texans,HOU,13974,16,6,10,0,.375,7,4,3,0,.571,9,2,7,0,.222,16,2120,,2006002,2006:2120,2006,2006
191,1400,NFL,1400,Denver Broncos,Denver Broncos,DEN,8810,16,9,7,0,.563,7,5,2,0,.714,9,4,5,0,.444,16,1400,,2006002,2006:1400,2006,2006
191,2520,NFL,2520,Oakland Raiders,Oakland Raiders,OAK,8822,16,2,14,0,.125,6,2,4,0,.333,10,0,10,0,.000,16,2520,,2006002,2006:2520,2006,2006
191,200,NFL,200,Atlanta Falcons,Atlanta Falcons,ATL,8802,16,7,9,0,.438,6,4,2,0,.667,10,3,7,0,.300,16,200,,2006002,2006:200,2006,2006
191,3700,NFL,3700,Philadelphia Eagles,Philadelphia Eagles,PHI,8823,16,10,6,0,.625,5,5,0,0,1.000,11,5,6,0,.455,16,3700,,2006002,2006:3700,2006,2006
191,1200,NFL,1200,Dallas Cowboys,Dallas Cowboys,DAL,8809,16,9,7,0,.563,5,3,2,0,.600,11,6,5,0,.545,16,1200,,2006002,2006:1200,2006,2006
191,3410,NFL,3410,New York Giants,New York Giants,NYG,8820,16,8,8,0,.500,13,7,6,0,.538,3,1,2,0,.333,16,3410,,2006002,2006:3410,2006,2006
191,3200,NFL,3200,New England Patriots,New England Patriots,NE,8818,16,12,4,0,.750,10,9,1,0,.900,6,3,3,0,.500,16,3200,,2006002,2006:3200,2006,2006
191,3430,NFL,3430,New York Jets,New York Jets,NYJ,8821,16,10,6,0,.625,8,7,1,0,.875,8,3,5,0,.375,16,3430,,2006002,2006:3430,2006,2006
191,4400,NFL,4400,San Diego Chargers,San Diego Chargers,SD,8825,16,14,2,0,.875,11,10,1,0,.909,5,4,1,0,.800,16,4400,,2006002,2006:4400,2006,2006
191,1540,NFL,1540,Detroit Lions,Detroit Lions,DET,8811,16,3,13,0,.188,6,3,3,0,.500,10,0,10,0,.000,16,1540,,2006002,2006:1540,2006,2006
191,3000,NFL,3000,Minnesota Vikings,Minnesota Vikings,MIN,8817,16,6,10,0,.375,10,5,5,0,.500,6,1,5,0,.167,16,3000,,2006002,2006:3000,2006,2006
191,920,NFL,920,Cincinnati Bengals,Cincinnati Bengals,CIN,8807,16,8,8,0,.500,9,5,4,0,.556,7,3,4,0,.429,16,920,,2006002,2006:920,2006,2006
191,750,NFL,750,Carolina Panthers,Carolina Panthers,CAR,8805,16,8,8,0,.500,9,4,5,0,.444,7,4,3,0,.571,16,750,,2006002,2006:750,2006,2006
191,2700,NFL,2700,Miami Dolphins,Miami Dolphins,MIA,8816,16,6,10,0,.375,7,3,4,0,.429,9,3,6,0,.333,16,2700,,2006002,2006:2700,2006,2006
223,610,NFL,610,Buffalo Bills,Buffalo Bills,BUF,8804,16,7,9,0,.438,8,5,3,0,.625,8,2,6,0,.250,16,610,,2007002,2007:610,2007,2007
223,2200,NFL,2200,Indianapolis Colts,Indianapolis Colts,IND,8813,16,13,3,0,.813,8,7,1,0,.875,8,6,2,0,.750,16,2200,,2007002,2007:2200,2007,2007
223,2310,NFL,2310,Kansas City Chiefs,Kansas City Chiefs,KC,8815,16,4,12,0,.250,4,2,2,0,.500,12,2,10,0,.167,16,2310,,2007002,2007:2310,2007,2007
223,4900,NFL,4900,Tampa Bay Buccaneers,Tampa Bay Buccaneers,TB,8829,16,9,7,0,.563,12,8,4,0,.667,4,1,3,0,.250,16,4900,,2007002,2007:4900,2007,2007
223,1800,NFL,1800,Green Bay Packers,Green Bay Packers,GB,8812,16,13,3,0,.813,11,9,2,0,.818,5,4,1,0,.800,16,1800,,2007002,2007:1800,2007,2007
223,3300,NFL,3300,New Orleans Saints,New Orleans Saints,NO,8819,16,7,9,0,.438,7,5,2,0,.714,9,2,7,0,.222,16,3300,,2007002,2007:3300,2007,2007
223,1050,NFL,1050,Cleveland Browns,Cleveland Browns,CLE,8808,16,10,6,0,.625,7,6,1,0,.857,9,4,5,0,.444,16,1050,,2007002,2007:1050,2007,2007
223,325,NFL,325,Baltimore Ravens,Baltimore Ravens,BAL,8803,16,5,11,0,.313,6,5,1,0,.833,10,0,10,0,.000,16,325,,2007002,2007:325,2007,2007
223,2510,NFL,2510,St. Louis Rams,St. Louis Rams,STL,8828,16,3,13,0,.188,7,2,5,0,.286,9,1,8,0,.111,16,2510,,2007002,2007:2510,2007,2007
223,3900,NFL,3900,Pittsburgh Steelers,Pittsburgh Steelers,PIT,8824,16,10,6,0,.625,9,6,3,0,.667,7,4,3,0,.571,16,3900,,2007002,2007:3900,2007,2007
223,810,NFL,810,Chicago Bears,Chicago Bears,CHI,8806,16,7,9,0,.438,10,4,6,0,.400,6,3,3,0,.500,16,810,,2007002,2007:810,2007,2007
223,2100,NFL,2100,Tennessee Titans,Tennessee Titans,TEN,8830,16,10,6,0,.625,8,7,1,0,.875,8,3,5,0,.375,16,2100,,2007002,2007:2100,2007,2007
223,5110,NFL,5110,Washington Redskins,Washington Redskins,WAS,8831,16,9,7,0,.563,10,8,2,0,.800,6,1,5,0,.167,16,5110,,2007002,2007:5110,2007,2007
223,4600,NFL,4600,Seattle Seahawks,Seattle Seahawks,SEA,8827,16,10,6,0,.625,9,7,2,0,.778,7,3,4,0,.429,16,4600,,2007002,2007:4600,2007,2007
223,4500,NFL,4500,San Francisco 49ers,San Francisco 49ers,SF,8826,16,5,11,0,.313,4,2,2,0,.500,12,3,9,0,.250,16,4500,,2007002,2007:4500,2007,2007
223,3800,NFL,3800,Arizona Cardinals,Arizona Cardinals,ARI,8801,16,8,8,0,.500,6,3,3,0,.500,10,5,5,0,.500,16,3800,,2007002,2007:3800,2007,2007
223,2250,NFL,2250,Jacksonville Jaguars,Jacksonville Jaguars,JAC,8814,16,11,5,0,.688,10,9,1,0,.900,6,2,4,0,.333,16,2250,,2007002,2007:2250,2007,2007
223,2120,NFL,2120,Houston Texans,Houston Texans,HOU,13974,16,8,8,0,.500,10,5,5,0,.500,6,3,3,0,.500,16,2120,,2007002,2007:2120,2007,2007
223,1400,NFL,1400,Denver Broncos,Denver Broncos,DEN,8810,16,7,9,0,.438,6,4,2,0,.667,10,3,7,0,.300,16,1400,,2007002,2007:1400,2007,2007
223,2520,NFL,2520,Oakland Raiders,Oakland Raiders,OAK,8822,16,4,12,0,.250,6,4,2,0,.667,10,0,10,0,.000,16,2520,,2007002,2007:2520,2007,2007
223,200,NFL,200,Atlanta Falcons,Atlanta Falcons,ATL,8802,16,4,12,0,.250,5,2,3,0,.400,11,2,9,0,.182,16,200,,2007002,2007:200,2007,2007
223,3700,NFL,3700,Philadelphia Eagles,Philadelphia Eagles,PHI,8823,16,8,8,0,.500,6,4,2,0,.667,10,4,6,0,.400,16,3700,,2007002,2007:3700,2007,2007
223,1200,NFL,1200,Dallas Cowboys,Dallas Cowboys,DAL,8809,16,13,3,0,.813,7,6,1,0,.857,9,7,2,0,.778,16,1200,,2007002,2007:1200,2007,2007
223,3410,NFL,3410,New York Giants,New York Giants,NYG,8820,16,10,6,0,.625,7,5,2,0,.714,9,5,4,0,.556,16,3410,,2007002,2007:3410,2007,2007
223,3200,NFL,3200,New England Patriots,New England Patriots,NE,8818,16,16,0,0,1.000,13,13,0,0,1.000,3,3,0,0,1.000,16,3200,,2007002,2007:3200,2007,2007
223,3430,NFL,3430,New York Jets,New York Jets,NYJ,8821,16,4,12,0,.250,8,4,4,0,.500,8,0,8,0,.000,16,3430,,2007002,2007:3430,2007,2007
223,4400,NFL,4400,San Diego Chargers,San Diego Chargers,SD,8825,16,11,5,0,.688,11,8,3,0,.727,5,3,2,0,.600,16,4400,,2007002,2007:4400,2007,2007
223,1540,NFL,1540,Detroit Lions,Detroit Lions,DET,8811,16,7,9,0,.438,11,7,4,0,.636,5,0,5,0,.000,16,1540,,2007002,2007:1540,2007,2007
223,3000,NFL,3000,Minnesota Vikings,Minnesota Vikings,MIN,8817,16,8,8,0,.500,8,5,3,0,.625,8,3,5,0,.375,16,3000,,2007002,2007:3000,2007,2007
223,920,NFL,920,Cincinnati Bengals,Cincinnati Bengals,CIN,8807,16,7,9,0,.438,9,5,4,0,.556,7,2,5,0,.286,16,920,,2007002,2007:920,2007,2007
223,750,NFL,750,Carolina Panthers,Carolina Panthers,CAR,8805,16,7,9,0,.438,9,6,3,0,.667,7,1,6,0,.143,16,750,,2007002,2007:750,2007,2007
223,2700,NFL,2700,Miami Dolphins,Miami Dolphins,MIA,8816,16,1,15,0,.063,4,0,4,0,.000,12,1,11,0,.083,16,2700,,2007002,2007:2700,2007,2007
255,610,NFL,610,Buffalo Bills,Buffalo Bills,BUF,8804,16,7,9,0,.438,4,4,0,0,1.000,12,3,9,0,.250,16,610,,2008002,2008:610,2008,2008
255,2200,NFL,2200,Indianapolis Colts,Indianapolis Colts,IND,8813,16,12,4,0,.750,9,7,2,0,.778,7,5,2,0,.714,16,2200,,2008002,2008:2200,2008,2008
255,2310,NFL,2310,Kansas City Chiefs,Kansas City Chiefs,KC,8815,16,2,14,0,.125,7,1,6,0,.143,9,1,8,0,.111,16,2310,,2008002,2008:2310,2008,2008
255,4900,NFL,4900,Tampa Bay Buccaneers,Tampa Bay Buccaneers,TB,8829,16,9,7,0,.563,5,3,2,0,.600,11,6,5,0,.545,16,4900,,2008002,2008:4900,2008,2008
255,1800,NFL,1800,Green Bay Packers,Green Bay Packers,GB,8812,16,6,10,0,.375,8,5,3,0,.625,8,1,7,0,.125,16,1800,,2008002,2008:1800,2008,2008
255,3300,NFL,3300,New Orleans Saints,New Orleans Saints,NO,8819,16,8,8,0,.500,6,4,2,0,.667,10,4,6,0,.400,16,3300,,2008002,2008:3300,2008,2008
255,1050,NFL,1050,Cleveland Browns,Cleveland Browns,CLE,8808,16,4,12,0,.250,7,4,3,0,.571,9,0,9,0,.000,16,1050,,2008002,2008:1050,2008,2008
255,325,NFL,325,Baltimore Ravens,Baltimore Ravens,BAL,8803,16,11,5,0,.688,10,8,2,0,.800,6,3,3,0,.500,16,325,,2008002,2008:325,2008,2008
255,2510,NFL,2510,St. Louis Rams,St. Louis Rams,STL,8828,16,2,14,0,.125,4,0,4,0,.000,12,2,10,0,.167,16,2510,,2008002,2008:2510,2008,2008
255,3900,NFL,3900,Pittsburgh Steelers,Pittsburgh Steelers,PIT,8824,16,12,4,0,.750,9,6,3,0,.667,7,6,1,0,.857,16,3900,,2008002,2008:3900,2008,2008
255,810,NFL,810,Chicago Bears,Chicago Bears,CHI,8806,16,9,7,0,.563,11,6,5,0,.545,5,3,2,0,.600,16,810,,2008002,2008:810,2008,2008
255,2100,NFL,2100,Tennessee Titans,Tennessee Titans,TEN,8830,16,13,3,0,.813,10,9,1,0,.900,6,4,2,0,.667,16,2100,,2008002,2008:2100,2008,2008
255,5110,NFL,5110,Washington Redskins,Washington Redskins,WAS,8831,16,8,8,0,.500,8,5,3,0,.625,8,3,5,0,.375,16,5110,,2008002,2008:5110,2008,2008
255,4600,NFL,4600,Seattle Seahawks,Seattle Seahawks,SEA,8827,16,4,12,0,.250,7,2,5,0,.286,9,2,7,0,.222,16,4600,,2008002,2008:4600,2008,2008
255,4500,NFL,4500,San Francisco 49ers,San Francisco 49ers,SF,8826,16,7,9,0,.438,11,6,5,0,.545,5,1,4,0,.200,16,4500,,2008002,2008:4500,2008,2008
255,3800,NFL,3800,Arizona Cardinals,Arizona Cardinals,ARI,8801,16,9,7,0,.563,8,6,2,0,.750,8,3,5,0,.375,16,3800,,2008002,2008:3800,2008,2008
255,2250,NFL,2250,Jacksonville Jaguars,Jacksonville Jaguars,JAC,8814,16,5,11,0,.313,5,3,2,0,.600,11,2,9,0,.182,16,2250,,2008002,2008:2250,2008,2008
255,2120,NFL,2120,Houston Texans,Houston Texans,HOU,13974,16,8,8,0,.500,7,5,2,0,.714,9,3,6,0,.333,16,2120,,2008002,2008:2120,2008,2008
255,1400,NFL,1400,Denver Broncos,Denver Broncos,DEN,8810,16,8,8,0,.500,9,6,3,0,.667,7,2,5,0,.286,16,1400,,2008002,2008:1400,2008,2008
255,2520,NFL,2520,Oakland Raiders,Oakland Raiders,OAK,8822,16,5,11,0,.313,8,4,4,0,.500,8,1,7,0,.125,16,2520,,2008002,2008:2520,2008,2008
255,200,NFL,200,Atlanta Falcons,Atlanta Falcons,ATL,8802,16,11,5,0,.688,12,11,1,0,.917,4,0,4,0,.000,16,200,,2008002,2008:200,2008,2008
255,3700,NFL,3700,Philadelphia Eagles,Philadelphia Eagles,PHI,8823,16,9,6,1,.594,8,5,3,0,.625,8,4,3,1,.563,16,3700,,2008002,2008:3700,2008,2008
255,1200,NFL,1200,Dallas Cowboys,Dallas Cowboys,DAL,8809,16,9,7,0,.563,8,5,3,0,.625,8,4,4,0,.500,16,1200,,2008002,2008:1200,2008,2008
255,3410,NFL,3410,New York Giants,New York Giants,NYG,8820,16,12,4,0,.750,8,8,0,0,1.000,8,4,4,0,.500,16,3410,,2008002,2008:3410,2008,2008
255,3200,NFL,3200,New England Patriots,New England Patriots,NE,8818,16,11,5,0,.688,9,8,1,0,.889,7,3,4,0,.429,16,3200,,2008002,2008:3200,2008,2008
255,3430,NFL,3430,New York Jets,New York Jets,NYJ,8821,16,9,7,0,.563,12,8,4,0,.667,4,1,3,0,.250,16,3430,,2008002,2008:3430,2008,2008
255,4400,NFL,4400,San Diego Chargers,San Diego Chargers,SD,8825,16,8,8,0,.500,6,4,2,0,.667,10,4,6,0,.400,16,4400,,2008002,2008:4400,2008,2008
255,1540,NFL,1540,Detroit Lions,Detroit Lions,DET,8811,16,0,16,0,.000,3,0,3,0,.000,13,0,13,0,.000,16,1540,,2008002,2008:1540,2008,2008
255,3000,NFL,3000,Minnesota Vikings,Minnesota Vikings,MIN,8817,16,10,6,0,.625,10,6,4,0,.600,6,4,2,0,.667,16,3000,,2008002,2008:3000,2008,2008
255,920,NFL,920,Cincinnati Bengals,Cincinnati Bengals,CIN,8807,16,4,11,1,.281,8,4,3,1,.563,8,0,8,0,.000,16,920,,2008002,2008:920,2008,2008
255,750,NFL,750,Carolina Panthers,Carolina Panthers,CAR,8805,16,12,4,0,.750,9,8,1,0,.889,7,4,3,0,.571,16,750,,2008002,2008:750,2008,2008
255,2700,NFL,2700,Miami Dolphins,Miami Dolphins,MIA,8816,16,11,5,0,.688,10,8,2,0,.800,6,3,3,0,.500,16,2700,,2008002,2008:2700,2008,2008
287,610,NFL,610,Buffalo Bills,Buffalo Bills,BUF,8804,16,6,10,0,.375,10,5,5,0,.500,6,1,5,0,.167,16,610,,2009002,2009:610,2009,2009
287,2200,NFL,2200,Indianapolis Colts,Indianapolis Colts,IND,8813,16,14,2,0,.875,10,9,1,0,.900,6,5,1,0,.833,16,2200,,2009002,2009:2200,2009,2009
287,2310,NFL,2310,Kansas City Chiefs,Kansas City Chiefs,KC,8815,16,4,12,0,.250,6,3,3,0,.500,10,1,9,0,.100,16,2310,,2009002,2009:2310,2009,2009
287,4900,NFL,4900,Tampa Bay Buccaneers,Tampa Bay Buccaneers,TB,8829,16,3,13,0,.188,5,0,5,0,.000,11,3,8,0,.273,16,4900,,2009002,2009:4900,2009,2009
287,1800,NFL,1800,Green Bay Packers,Green Bay Packers,GB,8812,16,11,5,0,.688,11,9,2,0,.818,5,2,3,0,.400,16,1800,,2009002,2009:1800,2009,2009
287,3300,NFL,3300,New Orleans Saints,New Orleans Saints,NO,8819,16,13,3,0,.813,8,7,1,0,.875,8,6,2,0,.750,16,3300,,2009002,2009:3300,2009,2009
287,1050,NFL,1050,Cleveland Browns,Cleveland Browns,CLE,8808,16,5,11,0,.313,10,5,5,0,.500,6,0,6,0,.000,16,1050,,2009002,2009:1050,2009,2009
287,325,NFL,325,Baltimore Ravens,Baltimore Ravens,BAL,8803,16,9,7,0,.563,9,8,1,0,.889,7,1,6,0,.143,16,325,,2009002,2009:325,2009,2009
287,2510,NFL,2510,St. Louis Rams,St. Louis Rams,STL,8828,16,1,15,0,.063,4,1,3,0,.250,12,0,12,0,.000,16,2510,,2009002,2009:2510,2009,2009
287,3900,NFL,3900,Pittsburgh Steelers,Pittsburgh Steelers,PIT,8824,16,9,7,0,.563,11,7,4,0,.636,5,2,3,0,.400,16,3900,,2009002,2009:3900,2009,2009
287,810,NFL,810,Chicago Bears,Chicago Bears,CHI,8806,16,7,9,0,.438,5,4,1,0,.800,11,3,8,0,.273,16,810,,2009002,2009:810,2009,2009
287,2100,NFL,2100,Tennessee Titans,Tennessee Titans,TEN,8830,16,8,8,0,.500,6,4,2,0,.667,10,4,6,0,.400,16,2100,,2009002,2009:2100,2009,2009
287,5110,NFL,5110,Washington Redskins,Washington Redskins,WAS,8831,16,4,12,0,.250,5,1,4,0,.200,11,3,8,0,.273,16,5110,,2009002,2009:5110,2009,2009
287,4600,NFL,4600,Seattle Seahawks,Seattle Seahawks,SEA,8827,16,5,11,0,.313,7,3,4,0,.429,9,2,7,0,.222,16,4600,,2009002,2009:4600,2009,2009
287,4500,NFL,4500,San Francisco 49ers,San Francisco 49ers,SF,8826,16,8,8,0,.500,9,6,3,0,.667,7,2,5,0,.286,16,4500,,2009002,2009:4500,2009,2009
287,3800,NFL,3800,Arizona Cardinals,Arizona Cardinals,ARI,8801,16,10,6,0,.625,7,6,1,0,.857,9,4,5,0,.444,16,3800,,2009002,2009:3800,2009,2009
287,2250,NFL,2250,Jacksonville Jaguars,Jacksonville Jaguars,JAC,8814,16,7,9,0,.438,7,5,2,0,.714,9,2,7,0,.222,16,2250,,2009002,2009:2250,2009,2009
287,2120,NFL,2120,Houston Texans,Houston Texans,HOU,13974,16,9,7,0,.563,9,7,2,0,.778,7,2,5,0,.286,16,2120,,2009002,2009:2120,2009,2009
287,1400,NFL,1400,Denver Broncos,Denver Broncos,DEN,8810,16,8,8,0,.500,7,4,3,0,.571,9,4,5,0,.444,16,1400,,2009002,2009:1400,2009,2009
287,2520,NFL,2520,Oakland Raiders,Oakland Raiders,OAK,8822,16,5,11,0,.313,3,0,3,0,.000,13,5,8,0,.385,16,2520,,2009002,2009:2520,2009,2009
287,200,NFL,200,Atlanta Falcons,Atlanta Falcons,ATL,8802,16,9,7,0,.563,11,6,5,0,.545,5,3,2,0,.600,16,200,,2009002,2009:200,2009,2009
287,3700,NFL,3700,Philadelphia Eagles,Philadelphia Eagles,PHI,8823,16,11,5,0,.688,10,9,1,0,.900,6,2,4,0,.333,16,3700,,2009002,2009:3700,2009,2009
287,1200,NFL,1200,Dallas Cowboys,Dallas Cowboys,DAL,8809,16,11,5,0,.688,9,6,3,0,.667,7,5,2,0,.714,16,1200,,2009002,2009:1200,2009,2009
287,3410,NFL,3410,New York Giants,New York Giants,NYG,8820,16,8,8,0,.500,8,7,1,0,.875,8,1,7,0,.125,16,3410,,2009002,2009:3410,2009,2009
287,3200,NFL,3200,New England Patriots,New England Patriots,NE,8818,16,10,6,0,.625,8,5,3,0,.625,8,5,3,0,.625,16,3200,,2009002,2009:3200,2009,2009
287,3430,NFL,3430,New York Jets,New York Jets,NYJ,8821,16,9,7,0,.563,7,6,1,0,.857,9,3,6,0,.333,16,3430,,2009002,2009:3430,2009,2009
287,4400,NFL,4400,San Diego Chargers,San Diego Chargers,SD,8825,16,13,3,0,.813,11,9,2,0,.818,5,4,1,0,.800,16,4400,,2009002,2009:4400,2009,2009
287,1540,NFL,1540,Detroit Lions,Detroit Lions,DET,8811,16,2,14,0,.125,8,1,7,0,.125,8,1,7,0,.125,16,1540,,2009002,2009:1540,2009,2009
287,3000,NFL,3000,Minnesota Vikings,Minnesota Vikings,MIN,8817,16,12,4,0,.750,10,9,1,0,.900,6,3,3,0,.500,16,3000,,2009002,2009:3000,2009,2009
287,920,NFL,920,Cincinnati Bengals,Cincinnati Bengals,CIN,8807,16,10,6,0,.625,7,6,1,0,.857,9,4,5,0,.444,16,920,,2009002,2009:920,2009,2009
287,750,NFL,750,Carolina Panthers,Carolina Panthers,CAR,8805,16,8,8,0,.500,11,5,6,0,.455,5,3,2,0,.600,16,750,,2009002,2009:750,2009,2009
287,2700,NFL,2700,Miami Dolphins,Miami Dolphins,MIA,8816,16,7,9,0,.438,7,3,4,0,.429,9,4,5,0,.444,16,2700,,2009002,2009:2700,2009,2009
319,610,NFL,610,Buffalo Bills,Buffalo Bills,BUF,8804,16,4,12,0,.250,6,2,4,0,.333,10,2,8,0,.200,16,610,,2010002,2010:610,2010,2010
319,2200,NFL,2200,Indianapolis Colts,Indianapolis Colts,IND,8813,16,10,6,0,.625,11,9,2,0,.818,5,1,4,0,.200,16,2200,,2010002,2010:2200,2010,2010
319,2310,NFL,2310,Kansas City Chiefs,Kansas City Chiefs,KC,8815,16,10,6,0,.625,10,7,3,0,.700,6,3,3,0,.500,16,2310,,2010002,2010:2310,2010,2010
319,4900,NFL,4900,Tampa Bay Buccaneers,Tampa Bay Buccaneers,TB,8829,16,10,6,0,.625,6,5,1,0,.833,10,5,5,0,.500,16,4900,,2010002,2010:4900,2010,2010
319,1800,NFL,1800,Green Bay Packers,Green Bay Packers,GB,8812,16,10,6,0,.625,11,6,5,0,.545,5,4,1,0,.800,16,1800,,2010002,2010:1800,2010,2010
319,3300,NFL,3300,New Orleans Saints,New Orleans Saints,NO,8819,16,11,5,0,.688,11,8,3,0,.727,5,3,2,0,.600,16,3300,,2010002,2010:3300,2010,2010
319,1050,NFL,1050,Cleveland Browns,Cleveland Browns,CLE,8808,16,5,11,0,.313,11,4,7,0,.364,5,1,4,0,.200,16,1050,,2010002,2010:1050,2010,2010
319,325,NFL,325,Baltimore Ravens,Baltimore Ravens,BAL,8803,16,12,4,0,.750,9,7,2,0,.778,7,5,2,0,.714,16,325,,2010002,2010:325,2010,2010
319,2510,NFL,2510,St. Louis Rams,St. Louis Rams,STL,8828,16,7,9,0,.438,9,5,4,0,.556,7,2,5,0,.286,16,2510,,2010002,2010:2510,2010,2010
319,3900,NFL,3900,Pittsburgh Steelers,Pittsburgh Steelers,PIT,8824,16,12,4,0,.750,8,6,2,0,.750,8,6,2,0,.750,16,3900,,2010002,2010:3900,2010,2010
319,810,NFL,810,Chicago Bears,Chicago Bears,CHI,8806,16,11,5,0,.688,9,6,3,0,.667,7,5,2,0,.714,16,810,,2010002,2010:810,2010,2010
319,2100,NFL,2100,Tennessee Titans,Tennessee Titans,TEN,8830,16,6,10,0,.375,6,4,2,0,.667,10,2,8,0,.200,16,2100,,2010002,2010:2100,2010,2010
319,5110,NFL,5110,Washington Redskins,Washington Redskins,WAS,8831,16,6,10,0,.375,6,3,3,0,.500,10,3,7,0,.300,16,5110,,2010002,2010:5110,2010,2010
319,4600,NFL,4600,Seattle Seahawks,Seattle Seahawks,SEA,8827,16,7,9,0,.438,6,3,3,0,.500,10,4,6,0,.400,16,4600,,2010002,2010:4600,2010,2010
319,4500,NFL,4500,San Francisco 49ers,San Francisco 49ers,SF,8826,16,6,10,0,.375,9,4,5,0,.444,7,2,5,0,.286,16,4500,,2010002,2010:4500,2010,2010
319,3800,NFL,3800,Arizona Cardinals,Arizona Cardinals,ARI,8801,16,5,11,0,.313,7,3,4,0,.429,9,2,7,0,.222,16,3800,,2010002,2010:3800,2010,2010
319,2250,NFL,2250,Jacksonville Jaguars,Jacksonville Jaguars,JAC,8814,16,8,8,0,.500,4,4,0,0,1.000,12,4,8,0,.333,16,2250,,2010002,2010:2250,2010,2010
319,2120,NFL,2120,Houston Texans,Houston Texans,HOU,13974,16,6,10,0,.375,7,4,3,0,.571,9,2,7,0,.222,16,2120,,2010002,2010:2120,2010,2010
319,1400,NFL,1400,Denver Broncos,Denver Broncos,DEN,8810,16,4,12,0,.250,7,3,4,0,.429,9,1,8,0,.111,16,1400,,2010002,2010:1400,2010,2010
319,2520,NFL,2520,Oakland Raiders,Oakland Raiders,OAK,8822,16,8,8,0,.500,11,5,6,0,.455,5,3,2,0,.600,16,2520,,2010002,2010:2520,2010,2010
319,200,NFL,200,Atlanta Falcons,Atlanta Falcons,ATL,8802,16,13,3,0,.813,9,9,0,0,1.000,7,4,3,0,.571,16,200,,2010002,2010:200,2010,2010
319,3700,NFL,3700,Philadelphia Eagles,Philadelphia Eagles,PHI,8823,16,10,6,0,.625,13,8,5,0,.615,3,2,1,0,.667,16,3700,,2010002,2010:3700,2010,2010
319,1200,NFL,1200,Dallas Cowboys,Dallas Cowboys,DAL,8809,16,6,10,0,.375,6,3,3,0,.500,10,3,7,0,.300,16,1200,,2010002,2010:1200,2010,2010
319,3410,NFL,3410,New York Giants,New York Giants,NYG,8820,16,10,6,0,.625,8,6,2,0,.750,8,4,4,0,.500,16,3410,,2010002,2010:3410,2010,2010
319,3200,NFL,3200,New England Patriots,New England Patriots,NE,8818,16,14,2,0,.875,8,7,1,0,.875,8,7,1,0,.875,16,3200,,2010002,2010:3200,2010,2010
319,3430,NFL,3430,New York Jets,New York Jets,NYJ,8821,16,11,5,0,.688,9,8,1,0,.889,7,3,4,0,.429,16,3430,,2010002,2010:3430,2010,2010
319,4400,NFL,4400,San Diego Chargers,San Diego Chargers,SD,8825,16,9,7,0,.563,6,4,2,0,.667,10,5,5,0,.500,16,4400,,2010002,2010:4400,2010,2010
319,1540,NFL,1540,Detroit Lions,Detroit Lions,DET,8811,16,6,10,0,.375,9,5,4,0,.556,7,1,6,0,.143,16,1540,,2010002,2010:1540,2010,2010
319,3000,NFL,3000,Minnesota Vikings,Minnesota Vikings,MIN,8817,16,6,10,0,.375,6,1,5,0,.167,10,5,5,0,.500,16,3000,,2010002,2010:3000,2010,2010
319,920,NFL,920,Cincinnati Bengals,Cincinnati Bengals,CIN,8807,16,4,12,0,.250,7,3,4,0,.429,9,1,8,0,.111,16,920,,2010002,2010:920,2010,2010
319,750,NFL,750,Carolina Panthers,Carolina Panthers,CAR,8805,16,2,14,0,.125,5,1,4,0,.200,11,1,10,0,.091,16,750,,2010002,2010:750,2010,2010
319,2700,NFL,2700,Miami Dolphins,Miami Dolphins,MIA,8816,16,7,9,0,.438,6,4,2,0,.667,10,3,7,0,.300,16,2700,,2010002,2010:2700,2010,2010
351,610,NFL,610,Buffalo Bills,Buffalo Bills,BUF,8804,16,6,10,0,.375,7,3,4,0,.429,9,3,6,0,.333,16,610,,2011002,2011:610,2011,2011
351,2200,NFL,2200,Indianapolis Colts,Indianapolis Colts,IND,8813,16,2,14,0,.125,4,1,3,0,.250,12,1,11,0,.083,16,2200,,2011002,2011:2200,2011,2011
351,2310,NFL,2310,Kansas City Chiefs,Kansas City Chiefs,KC,8815,16,7,9,0,.438,8,5,3,0,.625,8,2,6,0,.250,16,2310,,2011002,2011:2310,2011,2011
351,4900,NFL,4900,Tampa Bay Buccaneers,Tampa Bay Buccaneers,TB,8829,16,4,12,0,.250,4,2,2,0,.500,12,2,10,0,.167,16,4900,,2011002,2011:4900,2011,2011
351,1800,NFL,1800,Green Bay Packers,Green Bay Packers,GB,8812,16,15,1,0,.938,8,8,0,0,1.000,8,7,1,0,.875,16,1800,,2011002,2011:1800,2011,2011
351,3300,NFL,3300,New Orleans Saints,New Orleans Saints,NO,8819,16,13,3,0,.813,8,8,0,0,1.000,8,5,3,0,.625,16,3300,,2011002,2011:3300,2011,2011
351,1050,NFL,1050,Cleveland Browns,Cleveland Browns,CLE,8808,16,4,12,0,.250,7,1,6,0,.143,9,3,6,0,.333,16,1050,,2011002,2011:1050,2011,2011
351,325,NFL,325,Baltimore Ravens,Baltimore Ravens,BAL,8803,16,12,4,0,.750,10,10,0,0,1.000,6,2,4,0,.333,16,325,,2011002,2011:325,2011,2011
351,2510,NFL,2510,St. Louis Rams,St. Louis Rams,STL,8828,16,2,14,0,.125,6,1,5,0,.167,10,1,9,0,.100,16,2510,,2011002,2011:2510,2011,2011
351,3900,NFL,3900,Pittsburgh Steelers,Pittsburgh Steelers,PIT,8824,16,12,4,0,.750,8,8,0,0,1.000,8,4,4,0,.500,16,3900,,2011002,2011:3900,2011,2011
351,810,NFL,810,Chicago Bears,Chicago Bears,CHI,8806,16,8,8,0,.500,8,5,3,0,.625,8,3,5,0,.375,16,810,,2011002,2011:810,2011,2011
351,2100,NFL,2100,Tennessee Titans,Tennessee Titans,TEN,8830,16,9,7,0,.563,7,5,2,0,.714,9,4,5,0,.444,16,2100,,2011002,2011:2100,2011,2011
351,5110,NFL,5110,Washington Redskins,Washington Redskins,WAS,8831,16,5,11,0,.313,5,3,2,0,.600,11,2,9,0,.182,16,5110,,2011002,2011:5110,2011,2011
351,4600,NFL,4600,Seattle Seahawks,Seattle Seahawks,SEA,8827,16,7,9,0,.438,7,6,1,0,.857,9,1,8,0,.111,16,4600,,2011002,2011:4600,2011,2011
351,4500,NFL,4500,San Francisco 49ers,San Francisco 49ers,SF,8826,16,13,3,0,.813,9,7,2,0,.778,7,6,1,0,.857,16,4500,,2011002,2011:4500,2011,2011
351,3800,NFL,3800,Arizona Cardinals,Arizona Cardinals,ARI,8801,16,8,8,0,.500,7,4,3,0,.571,9,4,5,0,.444,16,3800,,2011002,2011:3800,2011,2011
351,2250,NFL,2250,Jacksonville Jaguars,Jacksonville Jaguars,JAC,8814,16,5,11,0,.313,7,4,3,0,.571,9,1,8,0,.111,16,2250,,2011002,2011:2250,2011,2011
351,2120,NFL,2120,Houston Texans,Houston Texans,HOU,13974,16,10,6,0,.625,13,9,4,0,.692,3,1,2,0,.333,16,2120,,2011002,2011:2120,2011,2011
351,1400,NFL,1400,Denver Broncos,Denver Broncos,DEN,8810,16,8,8,0,.500,9,3,6,0,.333,7,5,2,0,.714,16,1400,,2011002,2011:1400,2011,2011
351,2520,NFL,2520,Oakland Raiders,Oakland Raiders,OAK,8822,16,8,8,0,.500,9,4,5,0,.444,7,4,3,0,.571,16,2520,,2011002,2011:2520,2011,2011
351,200,NFL,200,Atlanta Falcons,Atlanta Falcons,ATL,8802,16,10,6,0,.625,11,8,3,0,.727,5,2,3,0,.400,16,200,,2011002,2011:200,2011,2011
351,3700,NFL,3700,Philadelphia Eagles,Philadelphia Eagles,PHI,8823,16,8,8,0,.500,9,6,3,0,.667,7,2,5,0,.286,16,3700,,2011002,2011:3700,2011,2011
351,1200,NFL,1200,Dallas Cowboys,Dallas Cowboys,DAL,8809,16,8,8,0,.500,7,5,2,0,.714,9,3,6,0,.333,16,1200,,2011002,2011:1200,2011,2011
351,3410,NFL,3410,New York Giants,New York Giants,NYG,8820,16,9,7,0,.563,8,5,3,0,.625,8,4,4,0,.500,16,3410,,2011002,2011:3410,2011,2011
351,3200,NFL,3200,New England Patriots,New England Patriots,NE,8818,16,13,3,0,.813,7,6,1,0,.857,9,7,2,0,.778,16,3200,,2011002,2011:3200,2011,2011
351,3430,NFL,3430,New York Jets,New York Jets,NYJ,8821,16,8,8,0,.500,4,3,1,0,.750,12,5,7,0,.417,16,3430,,2011002,2011:3430,2011,2011
351,4400,NFL,4400,San Diego Chargers,San Diego Chargers,SD,8825,16,8,8,0,.500,10,5,5,0,.500,6,3,3,0,.500,16,4400,,2011002,2011:4400,2011,2011
351,1540,NFL,1540,Detroit Lions,Detroit Lions,DET,8811,16,10,6,0,.625,8,5,3,0,.625,8,5,3,0,.625,16,1540,,2011002,2011:1540,2011,2011
351,3000,NFL,3000,Minnesota Vikings,Minnesota Vikings,MIN,8817,16,3,13,0,.188,11,3,8,0,.273,5,0,5,0,.000,16,3000,,2011002,2011:3000,2011,2011
351,920,NFL,920,Cincinnati Bengals,Cincinnati Bengals,CIN,8807,16,9,7,0,.563,8,6,2,0,.750,8,3,5,0,.375,16,920,,2011002,2011:920,2011,2011
351,750,NFL,750,Carolina Panthers,Carolina Panthers,CAR,8805,16,6,10,0,.375,10,6,4,0,.600,6,0,6,0,.000,16,750,,2011002,2011:750,2011,2011
351,2700,NFL,2700,Miami Dolphins,Miami Dolphins,MIA,8816,16,6,10,0,.375,12,3,9,0,.250,4,3,1,0,.750,16,2700,,2011002,2011:2700,2011,2011
383,610,NFL,610,Buffalo Bills,Buffalo Bills,BUF,8804,16,6,10,0,.375,5,4,1,0,.800,11,2,9,0,.182,16,610,,2012002,2012:610,2012,2012
383,2200,NFL,2200,Indianapolis Colts,Indianapolis Colts,IND,8813,16,11,5,0,.688,8,5,3,0,.625,8,6,2,0,.750,16,2200,,2012002,2012:2200,2012,2012
383,2310,NFL,2310,Kansas City Chiefs,Kansas City Chiefs,KC,8815,16,2,14,0,.125,5,1,4,0,.200,11,1,10,0,.091,16,2310,,2012002,2012:2310,2012,2012
383,4900,NFL,4900,Tampa Bay Buccaneers,Tampa Bay Buccaneers,TB,8829,16,7,9,0,.438,9,5,4,0,.556,7,2,5,0,.286,16,4900,,2012002,2012:4900,2012,2012
383,1800,NFL,1800,Green Bay Packers,Green Bay Packers,GB,8812,16,11,5,0,.688,7,6,1,0,.857,9,5,4,0,.556,16,1800,,2012002,2012:1800,2012,2012
383,3300,NFL,3300,New Orleans Saints,New Orleans Saints,NO,8819,16,7,9,0,.438,7,4,3,0,.571,9,3,6,0,.333,16,3300,,2012002,2012:3300,2012,2012
383,1050,NFL,1050,Cleveland Browns,Cleveland Browns,CLE,8808,16,5,11,0,.313,6,2,4,0,.333,10,3,7,0,.300,16,1050,,2012002,2012:1050,2012,2012
383,325,NFL,325,Baltimore Ravens,Baltimore Ravens,BAL,8803,16,10,6,0,.625,9,7,2,0,.778,7,3,4,0,.429,16,325,,2012002,2012:325,2012,2012
383,2510,NFL,2510,St. Louis Rams,St. Louis Rams,STL,8828,16,7,8,1,.469,7,1,5,1,.214,9,6,3,0,.667,16,2510,,2012002,2012:2510,2012,2012
383,3900,NFL,3900,Pittsburgh Steelers,Pittsburgh Steelers,PIT,8824,16,8,8,0,.500,11,7,4,0,.636,5,1,4,0,.200,16,3900,,2012002,2012:3900,2012,2012
383,810,NFL,810,Chicago Bears,Chicago Bears,CHI,8806,16,10,6,0,.625,9,7,2,0,.778,7,3,4,0,.429,16,810,,2012002,2012:810,2012,2012
383,2100,NFL,2100,Tennessee Titans,Tennessee Titans,TEN,8830,16,6,10,0,.375,8,4,4,0,.500,8,2,6,0,.250,16,2100,,2012002,2012:2100,2012,2012
383,5110,NFL,5110,Washington Redskins,Washington Redskins,WAS,8831,16,10,6,0,.625,7,3,4,0,.429,9,7,2,0,.778,16,5110,,2012002,2012:5110,2012,2012
383,4600,NFL,4600,Seattle Seahawks,Seattle Seahawks,SEA,8827,16,11,5,0,.688,13,9,4,0,.692,3,2,1,0,.667,16,4600,,2012002,2012:4600,2012,2012
383,4500,NFL,4500,San Francisco 49ers,San Francisco 49ers,SF,8826,16,11,4,1,.719,10,8,2,0,.800,6,3,2,1,.583,16,4500,,2012002,2012:4500,2012,2012
383,3800,NFL,3800,Arizona Cardinals,Arizona Cardinals,ARI,8801,16,5,11,0,.313,7,2,5,0,.286,9,3,6,0,.333,16,3800,,2012002,2012:3800,2012,2012
383,2250,NFL,2250,Jacksonville Jaguars,Jacksonville Jaguars,JAC,8814,16,2,14,0,.125,6,1,5,0,.167,10,1,9,0,.100,16,2250,,2012002,2012:2250,2012,2012
383,2120,NFL,2120,Houston Texans,Houston Texans,HOU,13974,16,12,4,0,.750,9,8,1,0,.889,7,4,3,0,.571,16,2120,,2012002,2012:2120,2012,2012
383,1400,NFL,1400,Denver Broncos,Denver Broncos,DEN,8810,16,13,3,0,.813,9,8,1,0,.889,7,5,2,0,.714,16,1400,,2012002,2012:1400,2012,2012
383,2520,NFL,2520,Oakland Raiders,Oakland Raiders,OAK,8822,16,4,12,0,.250,6,3,3,0,.500,10,1,9,0,.100,16,2520,,2012002,2012:2520,2012,2012
383,200,NFL,200,Atlanta Falcons,Atlanta Falcons,ATL,8802,16,13,3,0,.813,9,8,1,0,.889,7,5,2,0,.714,16,200,,2012002,2012:200,2012,2012
383,3700,NFL,3700,Philadelphia Eagles,Philadelphia Eagles,PHI,8823,16,4,12,0,.250,7,3,4,0,.429,9,1,8,0,.111,16,3700,,2012002,2012:3700,2012,2012
383,1200,NFL,1200,Dallas Cowboys,Dallas Cowboys,DAL,8809,16,8,8,0,.500,6,3,3,0,.500,10,5,5,0,.500,16,1200,,2012002,2012:1200,2012,2012
383,3410,NFL,3410,New York Giants,New York Giants,NYG,8820,16,9,7,0,.563,7,5,2,0,.714,9,4,5,0,.444,16,3410,,2012002,2012:3410,2012,2012
383,3200,NFL,3200,New England Patriots,New England Patriots,NE,8818,16,12,4,0,.750,8,7,1,0,.875,8,5,3,0,.625,16,3200,,2012002,2012:3200,2012,2012
383,3430,NFL,3430,New York Jets,New York Jets,NYJ,8821,16,6,10,0,.375,4,1,3,0,.250,12,5,7,0,.417,16,3430,,2012002,2012:3430,2012,2012
383,4400,NFL,4400,San Diego Chargers,San Diego Chargers,SD,8825,16,7,9,0,.438,11,6,5,0,.545,5,1,4,0,.200,16,4400,,2012002,2012:4400,2012,2012
383,1540,NFL,1540,Detroit Lions,Detroit Lions,DET,8811,16,4,12,0,.250,9,2,7,0,.222,7,2,5,0,.286,16,1540,,2012002,2012:1540,2012,2012
383,3000,NFL,3000,Minnesota Vikings,Minnesota Vikings,MIN,8817,16,10,6,0,.625,12,8,4,0,.667,4,2,2,0,.500,16,3000,,2012002,2012:3000,2012,2012
383,920,NFL,920,Cincinnati Bengals,Cincinnati Bengals,CIN,8807,16,10,6,0,.625,10,8,2,0,.800,6,2,4,0,.333,16,920,,2012002,2012:920,2012,2012
383,750,NFL,750,Carolina Panthers,Carolina Panthers,CAR,8805,16,7,9,0,.438,6,4,2,0,.667,10,3,7,0,.300,16,750,,2012002,2012:750,2012,2012
383,2700,NFL,2700,Miami Dolphins,Miami Dolphins,MIA,8816,16,7,9,0,.438,9,4,5,0,.444,7,3,4,0,.429,16,2700,,2012002,2012:2700,2012,2012
415,610,NFL,610,Buffalo Bills,Buffalo Bills,BUF,8804,16,6,10,0,.375,10,6,4,0,.600,6,0,6,0,.000,16,610,,2013002,2013:610,2013,2013
415,2200,NFL,2200,Indianapolis Colts,Indianapolis Colts,IND,8813,16,11,5,0,.688,6,5,1,0,.833,10,6,4,0,.600,16,2200,,2013002,2013:2200,2013,2013
415,2310,NFL,2310,Kansas City Chiefs,Kansas City Chiefs,KC,8815,16,11,5,0,.688,10,7,3,0,.700,6,4,2,0,.667,16,2310,,2013002,2013:2310,2013,2013
415,4900,NFL,4900,Tampa Bay Buccaneers,Tampa Bay Buccaneers,TB,8829,16,4,12,0,.250,9,4,5,0,.444,7,0,7,0,.000,16,4900,,2013002,2013:4900,2013,2013
415,1800,NFL,1800,Green Bay Packers,Green Bay Packers,GB,8812,16,8,7,1,.531,8,5,2,1,.688,8,3,5,0,.375,16,1800,,2013002,2013:1800,2013,2013
415,3300,NFL,3300,New Orleans Saints,New Orleans Saints,NO,8819,16,11,5,0,.688,7,6,1,0,.857,9,5,4,0,.556,16,3300,,2013002,2013:3300,2013,2013
415,1050,NFL,1050,Cleveland Browns,Cleveland Browns,CLE,8808,16,4,12,0,.250,8,2,6,0,.250,8,2,6,0,.250,16,1050,,2013002,2013:1050,2013,2013
415,325,NFL,325,Baltimore Ravens,Baltimore Ravens,BAL,8803,16,8,8,0,.500,7,4,3,0,.571,9,4,5,0,.444,16,325,,2013002,2013:325,2013,2013
415,2510,NFL,2510,St. Louis Rams,St. Louis Rams,STL,8828,16,7,9,0,.438,6,4,2,0,.667,10,3,7,0,.300,16,2510,,2013002,2013:2510,2013,2013
415,3900,NFL,3900,Pittsburgh Steelers,Pittsburgh Steelers,PIT,8824,16,8,8,0,.500,8,5,3,0,.625,8,3,5,0,.375,16,3900,,2013002,2013:3900,2013,2013
415,810,NFL,810,Chicago Bears,Chicago Bears,CHI,8806,16,8,8,0,.500,7,3,4,0,.429,9,5,4,0,.556,16,810,,2013002,2013:810,2013,2013
415,2100,NFL,2100,Tennessee Titans,Tennessee Titans,TEN,8830,16,7,9,0,.438,7,3,4,0,.429,9,4,5,0,.444,16,2100,,2013002,2013:2100,2013,2013
415,5110,NFL,5110,Washington Redskins,Washington Redskins,WAS,8831,16,3,13,0,.188,6,1,5,0,.167,10,2,8,0,.200,16,5110,,2013002,2013:5110,2013,2013
415,4600,NFL,4600,Seattle Seahawks,Seattle Seahawks,SEA,8827,16,13,3,0,.813,12,10,2,0,.833,4,3,1,0,.750,16,4600,,2013002,2013:4600,2013,2013
415,4500,NFL,4500,San Francisco 49ers,San Francisco 49ers,SF,8826,16,12,4,0,.750,12,11,1,0,.917,4,1,3,0,.250,16,4500,,2013002,2013:4500,2013,2013
415,3800,NFL,3800,Arizona Cardinals,Arizona Cardinals,ARI,8801,16,10,6,0,.625,6,4,2,0,.667,10,6,4,0,.600,16,3800,,2013002,2013:3800,2013,2013
415,2250,NFL,2250,Jacksonville Jaguars,Jacksonville Jaguars,JAC,8814,16,4,12,0,.250,7,3,4,0,.429,9,1,8,0,.111,16,2250,,2013002,2013:2250,2013,2013
415,2120,NFL,2120,Houston Texans,Houston Texans,HOU,13974,16,2,14,0,.125,6,1,5,0,.167,10,1,9,0,.100,16,2120,,2013002,2013:2120,2013,2013
415,1400,NFL,1400,Denver Broncos,Denver Broncos,DEN,8810,16,13,3,0,.813,11,8,3,0,.727,5,5,0,0,1.000,16,1400,,2013002,2013:1400,2013,2013
415,2520,NFL,2520,Oakland Raiders,Oakland Raiders,OAK,8822,16,4,12,0,.250,9,4,5,0,.444,7,0,7,0,.000,16,2520,,2013002,2013:2520,2013,2013
415,200,NFL,200,Atlanta Falcons,Atlanta Falcons,ATL,8802,16,4,12,0,.250,9,3,6,0,.333,7,1,6,0,.143,16,200,,2013002,2013:200,2013,2013
415,3700,NFL,3700,Philadelphia Eagles,Philadelphia Eagles,PHI,8823,16,10,6,0,.625,7,7,0,0,1.000,9,3,6,0,.333,16,3700,,2013002,2013:3700,2013,2013
415,1200,NFL,1200,Dallas Cowboys,Dallas Cowboys,DAL,8809,16,8,8,0,.500,11,7,4,0,.636,5,1,4,0,.200,16,1200,,2013002,2013:1200,2013,2013
415,3410,NFL,3410,New York Giants,New York Giants,NYG,8820,16,7,9,0,.438,6,4,2,0,.667,10,3,7,0,.300,16,3410,,2013002,2013:3410,2013,2013
415,3200,NFL,3200,New England Patriots,New England Patriots,NE,8818,16,12,4,0,.750,7,6,1,0,.857,9,6,3,0,.667,16,3200,,2013002,2013:3200,2013,2013
415,3430,NFL,3430,New York Jets,New York Jets,NYJ,8821,16,8,8,0,.500,8,6,2,0,.750,8,2,6,0,.250,16,3430,,2013002,2013:3430,2013,2013
415,4400,NFL,4400,San Diego Chargers,San Diego Chargers,SD,8825,16,9,7,0,.563,9,6,3,0,.667,7,3,4,0,.429,16,4400,,2013002,2013:4400,2013,2013
415,1540,NFL,1540,Detroit Lions,Detroit Lions,DET,8811,16,7,9,0,.438,5,3,2,0,.600,11,4,7,0,.364,16,1540,,2013002,2013:1540,2013,2013
415,3000,NFL,3000,Minnesota Vikings,Minnesota Vikings,MIN,8817,16,5,10,1,.344,7,3,4,0,.429,9,2,6,1,.278,16,3000,,2013002,2013:3000,2013,2013
415,920,NFL,920,Cincinnati Bengals,Cincinnati Bengals,CIN,8807,16,11,5,0,.688,9,8,1,0,.889,7,3,4,0,.429,16,920,,2013002,2013:920,2013,2013
415,750,NFL,750,Carolina Panthers,Carolina Panthers,CAR,8805,16,12,4,0,.750,10,8,2,0,.800,6,4,2,0,.667,16,750,,2013002,2013:750,2013,2013
415,2700,NFL,2700,Miami Dolphins,Miami Dolphins,MIA,8816,16,8,8,0,.500,6,4,2,0,.667,10,4,6,0,.400,16,2700,,2013002,2013:2700,2013,2013
447,610,NFL,610,Buffalo Bills,Buffalo Bills,BUF,8804,16,9,7,0,.563,7,4,3,0,.571,9,5,4,0,.556,16,610,,2014002,2014:610,2014,2014
447,2200,NFL,2200,Indianapolis Colts,Indianapolis Colts,IND,8813,16,11,5,0,.688,9,8,1,0,.889,7,3,4,0,.429,16,2200,,2014002,2014:2200,2014,2014
447,2310,NFL,2310,Kansas City Chiefs,Kansas City Chiefs,KC,8815,16,9,7,0,.563,8,6,2,0,.750,8,3,5,0,.375,16,2310,,2014002,2014:2310,2014,2014
447,4900,NFL,4900,Tampa Bay Buccaneers,Tampa Bay Buccaneers,TB,8829,16,2,14,0,.125,7,2,5,0,.286,9,0,9,0,.000,16,4900,,2014002,2014:4900,2014,2014
447,1800,NFL,1800,Green Bay Packers,Green Bay Packers,GB,8812,16,12,4,0,.750,12,10,2,0,.833,4,2,2,0,.500,16,1800,,2014002,2014:1800,2014,2014
447,3300,NFL,3300,New Orleans Saints,New Orleans Saints,NO,8819,16,7,9,0,.438,8,4,4,0,.500,8,3,5,0,.375,16,3300,,2014002,2014:3300,2014,2014
447,1050,NFL,1050,Cleveland Browns,Cleveland Browns,CLE,8808,16,7,9,0,.438,7,4,3,0,.571,9,3,6,0,.333,16,1050,,2014002,2014:1050,2014,2014
447,325,NFL,325,Baltimore Ravens,Baltimore Ravens,BAL,8803,16,10,6,0,.625,10,8,2,0,.800,6,2,4,0,.333,16,325,,2014002,2014:325,2014,2014
447,2510,NFL,2510,St. Louis Rams,St. Louis Rams,STL,8828,16,6,10,0,.375,9,3,6,0,.333,7,3,4,0,.429,16,2510,,2014002,2014:2510,2014,2014
447,3900,NFL,3900,Pittsburgh Steelers,Pittsburgh Steelers,PIT,8824,16,11,5,0,.688,8,6,2,0,.750,8,5,3,0,.625,16,3900,,2014002,2014:3900,2014,2014
447,810,NFL,810,Chicago Bears,Chicago Bears,CHI,8806,16,5,11,0,.313,4,1,3,0,.250,12,4,8,0,.333,16,810,,2014002,2014:810,2014,2014
447,2100,NFL,2100,Tennessee Titans,Tennessee Titans,TEN,8830,16,2,14,0,.125,5,0,5,0,.000,11,2,9,0,.182,16,2100,,2014002,2014:2100,2014,2014
447,5110,NFL,5110,Washington Redskins,Washington Redskins,WAS,8831,16,4,12,0,.250,9,4,5,0,.444,7,0,7,0,.000,16,5110,,2014002,2014:5110,2014,2014
447,4600,NFL,4600,Seattle Seahawks,Seattle Seahawks,SEA,8827,16,12,4,0,.750,9,7,2,0,.778,7,5,2,0,.714,16,4600,,2014002,2014:4600,2014,2014
447,4500,NFL,4500,San Francisco 49ers,San Francisco 49ers,SF,8826,16,8,8,0,.500,6,3,3,0,.500,10,5,5,0,.500,16,4500,,2014002,2014:4500,2014,2014
447,3800,NFL,3800,Arizona Cardinals,Arizona Cardinals,ARI,8801,16,11,5,0,.688,10,7,3,0,.700,6,4,2,0,.667,16,3800,,2014002,2014:3800,2014,2014
447,2250,NFL,2250,Jacksonville Jaguars,Jacksonville Jaguars,JAC,8814,16,3,13,0,.188,5,0,5,0,.000,11,3,8,0,.273,16,2250,,2014002,2014:2250,2014,2014
447,2120,NFL,2120,Houston Texans,Houston Texans,HOU,13974,16,9,7,0,.563,7,5,2,0,.714,9,4,5,0,.444,16,2120,,2014002,2014:2120,2014,2014
447,1400,NFL,1400,Denver Broncos,Denver Broncos,DEN,8810,16,12,4,0,.750,10,9,1,0,.900,6,3,3,0,.500,16,1400,,2014002,2014:1400,2014,2014
447,2520,NFL,2520,Oakland Raiders,Oakland Raiders,OAK,8822,16,3,13,0,.188,7,2,5,0,.286,9,1,8,0,.111,16,2520,,2014002,2014:2520,2014,2014
447,200,NFL,200,Atlanta Falcons,Atlanta Falcons,ATL,8802,16,6,10,0,.375,5,2,3,0,.400,11,4,7,0,.364,16,200,,2014002,2014:200,2014,2014
447,3700,NFL,3700,Philadelphia Eagles,Philadelphia Eagles,PHI,8823,16,10,6,0,.625,10,7,3,0,.700,6,3,3,0,.500,16,3700,,2014002,2014:3700,2014,2014
447,1200,NFL,1200,Dallas Cowboys,Dallas Cowboys,DAL,8809,16,12,4,0,.750,10,9,1,0,.900,6,3,3,0,.500,16,1200,,2014002,2014:1200,2014,2014
447,3410,NFL,3410,New York Giants,New York Giants,NYG,8820,16,6,10,0,.375,9,5,4,0,.556,7,1,6,0,.143,16,3410,,2014002,2014:3410,2014,2014
447,3200,NFL,3200,New England Patriots,New England Patriots,NE,8818,16,12,4,0,.750,9,9,0,0,1.000,7,3,4,0,.429,16,3200,,2014002,2014:3200,2014,2014
447,3430,NFL,3430,New York Jets,New York Jets,NYJ,8821,16,4,12,0,.250,5,2,3,0,.400,11,2,9,0,.182,16,3430,,2014002,2014:3430,2014,2014
447,4400,NFL,4400,San Diego Chargers,San Diego Chargers,SD,8825,16,9,7,0,.563,7,6,1,0,.857,9,3,6,0,.333,16,4400,,2014002,2014:4400,2014,2014
447,1540,NFL,1540,Detroit Lions,Detroit Lions,DET,8811,16,11,5,0,.688,8,6,2,0,.750,8,5,3,0,.625,16,1540,,2014002,2014:1540,2014,2014
447,3000,NFL,3000,Minnesota Vikings,Minnesota Vikings,MIN,8817,16,7,9,0,.438,11,6,5,0,.545,5,1,4,0,.200,16,3000,,2014002,2014:3000,2014,2014
447,920,NFL,920,Cincinnati Bengals,Cincinnati Bengals,CIN,8807,16,10,5,1,.656,6,6,0,0,1.000,10,4,5,1,.450,16,920,,2014002,2014:920,2014,2014
447,750,NFL,750,Carolina Panthers,Carolina Panthers,CAR,8805,16,7,8,1,.469,11,7,3,1,.682,5,0,5,0,.000,16,750,,2014002,2014:750,2014,2014
447,2700,NFL,2700,Miami Dolphins,Miami Dolphins,MIA,8816,16,8,8,0,.500,8,5,3,0,.625,8,3,5,0,.375,16,2700,,2014002,2014:2700,2014,2014
479,610,NFL,610,Buffalo Bills,Buffalo Bills,BUF,8804,16,8,8,0,.500,9,5,4,0,.556,7,3,4,0,.429,16,610,,2015002,2015:610,2015,2015
479,2200,NFL,2200,Indianapolis Colts,Indianapolis Colts,IND,8813,16,8,8,0,.500,10,7,3,0,.700,6,1,5,0,.167,16,2200,,2015002,2015:2200,2015,2015
479,2310,NFL,2310,Kansas City Chiefs,Kansas City Chiefs,KC,8815,16,11,5,0,.688,10,8,2,0,.800,6,3,3,0,.500,16,2310,,2015002,2015:2310,2015,2015
479,4900,NFL,4900,Tampa Bay Buccaneers,Tampa Bay Buccaneers,TB,8829,16,6,10,0,.375,7,3,4,0,.429,9,3,6,0,.333,16,4900,,2015002,2015:4900,2015,2015
479,1800,NFL,1800,Green Bay Packers,Green Bay Packers,GB,8812,16,10,6,0,.625,10,8,2,0,.800,6,2,4,0,.333,16,1800,,2015002,2015:1800,2015,2015
479,3300,NFL,3300,New Orleans Saints,New Orleans Saints,NO,8819,16,7,9,0,.438,8,4,4,0,.500,8,3,5,0,.375,16,3300,,2015002,2015:3300,2015,2015
479,1050,NFL,1050,Cleveland Browns,Cleveland Browns,CLE,8808,16,3,13,0,.188,5,2,3,0,.400,11,1,10,0,.091,16,1050,,2015002,2015:1050,2015,2015
479,325,NFL,325,Baltimore Ravens,Baltimore Ravens,BAL,8803,16,5,11,0,.313,6,3,3,0,.500,10,2,8,0,.200,16,325,,2015002,2015:325,2015,2015
479,2510,NFL,2510,St. Louis Rams,St. Louis Rams,STL,8828,16,7,9,0,.438,8,5,3,0,.625,8,2,6,0,.250,16,2510,,2015002,2015:2510,2015,2015
479,3900,NFL,3900,Pittsburgh Steelers,Pittsburgh Steelers,PIT,8824,16,10,6,0,.625,9,6,3,0,.667,7,4,3,0,.571,16,3900,,2015002,2015:3900,2015,2015
479,810,NFL,810,Chicago Bears,Chicago Bears,CHI,8806,16,6,10,0,.375,4,1,3,0,.250,12,5,7,0,.417,16,810,,2015002,2015:810,2015,2015
479,2100,NFL,2100,Tennessee Titans,Tennessee Titans,TEN,8830,16,3,13,0,.188,7,2,5,0,.286,9,1,8,0,.111,16,2100,,2015002,2015:2100,2015,2015
479,5110,NFL,5110,Washington Redskins,Washington Redskins,WAS,8831,16,9,7,0,.563,10,7,3,0,.700,6,2,4,0,.333,16,5110,,2015002,2015:5110,2015,2015
479,4600,NFL,4600,Seattle Seahawks,Seattle Seahawks,SEA,8827,16,10,6,0,.625,10,8,2,0,.800,6,2,4,0,.333,16,4600,,2015002,2015:4600,2015,2015
479,4500,NFL,4500,San Francisco 49ers,San Francisco 49ers,SF,8826,16,5,11,0,.313,5,2,3,0,.400,11,3,8,0,.273,16,4500,,2015002,2015:4500,2015,2015
479,3800,NFL,3800,Arizona Cardinals,Arizona Cardinals,ARI,8801,16,13,3,0,.813,11,10,1,0,.909,5,3,2,0,.600,16,3800,,2015002,2015:3800,2015,2015
479,2250,NFL,2250,Jacksonville Jaguars,Jacksonville Jaguars,JAC,8814,16,5,11,0,.313,5,3,2,0,.600,11,2,9,0,.182,16,2250,,2015002,2015:2250,2015,2015
479,2120,NFL,2120,Houston Texans,Houston Texans,HOU,13974,16,9,7,0,.563,7,6,1,0,.857,9,3,6,0,.333,16,2120,,2015002,2015:2120,2015,2015
479,1400,NFL,1400,Denver Broncos,Denver Broncos,DEN,8810,16,12,4,0,.750,10,9,1,0,.900,6,3,3,0,.500,16,1400,,2015002,2015:1400,2015,2015
479,2520,NFL,2520,Oakland Raiders,Oakland Raiders,OAK,8822,16,7,9,0,.438,5,3,2,0,.600,11,4,7,0,.364,16,2520,,2015002,2015:2520,2015,2015
479,200,NFL,200,Atlanta Falcons,Atlanta Falcons,ATL,8802,16,8,8,0,.500,8,4,4,0,.500,8,4,4,0,.500,16,200,,2015002,2015:200,2015,2015
479,3700,NFL,3700,Philadelphia Eagles,Philadelphia Eagles,PHI,8823,16,7,9,0,.438,5,3,2,0,.600,11,4,7,0,.364,16,3700,,2015002,2015:3700,2015,2015
479,1200,NFL,1200,Dallas Cowboys,Dallas Cowboys,DAL,8809,16,4,12,0,.250,11,4,7,0,.364,5,0,5,0,.000,16,1200,,2015002,2015:1200,2015,2015
479,3410,NFL,3410,New York Giants,New York Giants,NYG,8820,16,6,10,0,.375,5,3,2,0,.600,11,3,8,0,.273,16,3410,,2015002,2015:3410,2015,2015
479,3200,NFL,3200,New England Patriots,New England Patriots,NE,8818,16,12,4,0,.750,12,10,2,0,.833,4,2,2,0,.500,16,3200,,2015002,2015:3200,2015,2015
479,3430,NFL,3430,New York Jets,New York Jets,NYJ,8821,16,10,6,0,.625,8,6,2,0,.750,8,4,4,0,.500,16,3430,,2015002,2015:3430,2015,2015
479,4400,NFL,4400,San Diego Chargers,San Diego Chargers,SD,8825,16,4,12,0,.250,4,1,3,0,.250,12,3,9,0,.250,16,4400,,2015002,2015:4400,2015,2015
479,1540,NFL,1540,Detroit Lions,Detroit Lions,DET,8811,16,7,9,0,.438,10,5,5,0,.500,6,2,4,0,.333,16,1540,,2015002,2015:1540,2015,2015
479,3000,NFL,3000,Minnesota Vikings,Minnesota Vikings,MIN,8817,16,11,5,0,.688,9,9,0,0,1.000,7,2,5,0,.286,16,3000,,2015002,2015:3000,2015,2015
479,920,NFL,920,Cincinnati Bengals,Cincinnati Bengals,CIN,8807,16,12,4,0,.750,12,9,3,0,.750,4,3,1,0,.750,16,920,,2015002,2015:920,2015,2015
479,750,NFL,750,Carolina Panthers,Carolina Panthers,CAR,8805,16,15,1,0,.938,11,10,1,0,.909,5,5,0,0,1.000,16,750,,2015002,2015:750,2015,2015
479,2700,NFL,2700,Miami Dolphins,Miami Dolphins,MIA,8816,16,6,10,0,.375,5,5,0,0,1.000,11,1,10,0,.091,16,2700,,2015002,2015:2700,2015,2015
511,610,NFL,610,Buffalo Bills,Buffalo Bills,BUF,8804,16,7,9,0,.438,7,4,3,0,.571,9,3,6,0,.333,16,610,,2016002,2016:610,2016,2016
511,2200,NFL,2200,Indianapolis Colts,Indianapolis Colts,IND,8813,16,8,8,0,.500,8,5,3,0,.625,8,3,5,0,.375,16,2200,,2016002,2016:2200,2016,2016
511,2310,NFL,2310,Kansas City Chiefs,Kansas City Chiefs,KC,8815,16,12,4,0,.750,8,6,2,0,.750,8,6,2,0,.750,16,2310,,2016002,2016:2310,2016,2016
511,4900,NFL,4900,Tampa Bay Buccaneers,Tampa Bay Buccaneers,TB,8829,16,9,7,0,.563,9,6,3,0,.667,7,3,4,0,.429,16,4900,,2016002,2016:4900,2016,2016
511,1800,NFL,1800,Green Bay Packers,Green Bay Packers,GB,8812,16,10,6,0,.625,11,10,1,0,.909,5,0,5,0,.000,16,1800,,2016002,2016:1800,2016,2016
511,3300,NFL,3300,New Orleans Saints,New Orleans Saints,NO,8819,16,7,9,0,.438,5,3,2,0,.600,11,4,7,0,.364,16,3300,,2016002,2016:3300,2016,2016
511,1050,NFL,1050,Cleveland Browns,Cleveland Browns,CLE,8808,16,1,15,0,.063,4,0,4,0,.000,12,1,11,0,.083,16,1050,,2016002,2016:1050,2016,2016
511,325,NFL,325,Baltimore Ravens,Baltimore Ravens,BAL,8803,16,8,8,0,.500,11,7,4,0,.636,5,1,4,0,.200,16,325,,2016002,2016:325,2016,2016
511,2510,NFL,2510,Los Angeles Rams,Los Angeles Rams,LA,8828,16,4,12,0,.250,8,4,4,0,.500,8,0,8,0,.000,16,2510,,2016002,2016:2510,2016,2016
511,3900,NFL,3900,Pittsburgh Steelers,Pittsburgh Steelers,PIT,8824,16,11,5,0,.688,8,7,1,0,.875,8,4,4,0,.500,16,3900,,2016002,2016:3900,2016,2016
511,810,NFL,810,Chicago Bears,Chicago Bears,CHI,8806,16,3,13,0,.188,7,2,5,0,.286,9,1,8,0,.111,16,810,,2016002,2016:810,2016,2016
511,2100,NFL,2100,Tennessee Titans,Tennessee Titans,TEN,8830,16,9,7,0,.563,9,6,3,0,.667,7,3,4,0,.429,16,2100,,2016002,2016:2100,2016,2016
511,5110,NFL,5110,Washington Football Team,Washington Football Team,WAS,8831,16,8,7,1,.531,7,5,1,1,.786,9,3,6,0,.333,16,5110,,2016002,2016:5110,2016,2016
511,4600,NFL,4600,Seattle Seahawks,Seattle Seahawks,SEA,8827,16,10,5,1,.656,8,7,1,0,.875,8,3,4,1,.438,16,4600,,2016002,2016:4600,2016,2016
511,4500,NFL,4500,San Francisco 49ers,San Francisco 49ers,SF,8826,16,2,14,0,.125,11,2,9,0,.182,5,0,5,0,.000,16,4500,,2016002,2016:4500,2016,2016
511,3800,NFL,3800,Arizona Cardinals,Arizona Cardinals,ARI,8801,16,7,8,1,.469,9,6,2,1,.722,7,1,6,0,.143,16,3800,,2016002,2016:3800,2016,2016
511,2250,NFL,2250,Jacksonville Jaguars,Jacksonville Jaguars,JAX,8814,16,3,13,0,.188,8,3,5,0,.375,8,0,8,0,.000,16,2250,,2016002,2016:2250,2016,2016
511,2120,NFL,2120,Houston Texans,Houston Texans,HOU,13974,16,9,7,0,.563,7,4,3,0,.571,9,5,4,0,.556,16,2120,,2016002,2016:2120,2016,2016
511,1400,NFL,1400,Denver Broncos,Denver Broncos,DEN,8810,16,9,7,0,.563,4,4,0,0,1.000,12,5,7,0,.417,16,1400,,2016002,2016:1400,2016,2016
511,2520,NFL,2520,Oakland Raiders,Oakland Raiders,OAK,8822,16,12,4,0,.750,9,7,2,0,.778,7,5,2,0,.714,16,2520,,2016002,2016:2520,2016,2016
511,200,NFL,200,Atlanta Falcons,Atlanta Falcons,ATL,8802,16,11,5,0,.688,9,8,1,0,.889,7,3,4,0,.429,16,200,,2016002,2016:200,2016,2016
511,3700,NFL,3700,Philadelphia Eagles,Philadelphia Eagles,PHI,8823,16,7,9,0,.438,8,6,2,0,.750,8,1,7,0,.125,16,3700,,2016002,2016:3700,2016,2016
511,1200,NFL,1200,Dallas Cowboys,Dallas Cowboys,DAL,8809,16,13,3,0,.813,8,6,2,0,.750,8,7,1,0,.875,16,1200,,2016002,2016:1200,2016,2016
511,3410,NFL,3410,New York Giants,New York Giants,NYG,8820,16,11,5,0,.688,7,6,1,0,.857,9,5,4,0,.556,16,3410,,2016002,2016:3410,2016,2016
511,3200,NFL,3200,New England Patriots,New England Patriots,NE,8818,16,14,2,0,.875,13,12,1,0,.923,3,2,1,0,.667,16,3200,,2016002,2016:3200,2016,2016
511,3430,NFL,3430,New York Jets,New York Jets,NYJ,8821,16,5,11,0,.313,8,2,6,0,.250,8,3,5,0,.375,16,3430,,2016002,2016:3430,2016,2016
511,4400,NFL,4400,San Diego Chargers,San Diego Chargers,SD,8825,16,5,11,0,.313,9,4,5,0,.444,7,1,6,0,.143,16,4400,,2016002,2016:4400,2016,2016
511,1540,NFL,1540,Detroit Lions,Detroit Lions,DET,8811,16,9,7,0,.563,8,7,1,0,.875,8,2,6,0,.250,16,1540,,2016002,2016:1540,2016,2016
511,3000,NFL,3000,Minnesota Vikings,Minnesota Vikings,MIN,8817,16,8,8,0,.500,7,5,2,0,.714,9,3,6,0,.333,16,3000,,2016002,2016:3000,2016,2016
511,920,NFL,920,Cincinnati Bengals,Cincinnati Bengals,CIN,8807,16,6,9,1,.406,8,5,3,0,.625,8,1,6,1,.188,16,920,,2016002,2016:920,2016,2016
511,750,NFL,750,Carolina Panthers,Carolina Panthers,CAR,8805,16,6,10,0,.375,8,5,3,0,.625,8,1,7,0,.125,16,750,,2016002,2016:750,2016,2016
511,2700,NFL,2700,Miami Dolphins,Miami Dolphins,MIA,8816,16,10,6,0,.625,5,5,0,0,1.000,11,5,6,0,.455,16,2700,,2016002,2016:2700,2016,2016
543,610,NFL,610,Buffalo Bills,Buffalo Bills,BUF,8804,16,9,7,0,.563,7,5,2,0,.714,9,4,5,0,.444,16,610,,2017002,2017:610,2017,2017
543,2200,NFL,2200,Indianapolis Colts,Indianapolis Colts,IND,8813,16,4,12,0,.250,6,3,3,0,.500,10,1,9,0,.100,16,2200,,2017002,2017:2200,2017,2017
543,2310,NFL,2310,Kansas City Chiefs,Kansas City Chiefs,KC,8815,16,10,6,0,.625,10,8,2,0,.800,6,2,4,0,.333,16,2310,,2017002,2017:2310,2017,2017
543,4900,NFL,4900,Tampa Bay Buccaneers,Tampa Bay Buccaneers,TB,8829,16,5,11,0,.313,8,5,3,0,.625,8,0,8,0,.000,16,4900,,2017002,2017:4900,2017,2017
543,1800,NFL,1800,Green Bay Packers,Green Bay Packers,GB,8812,16,7,9,0,.438,5,3,2,0,.600,11,4,7,0,.364,16,1800,,2017002,2017:1800,2017,2017
543,3300,NFL,3300,New Orleans Saints,New Orleans Saints,NO,8819,16,11,5,0,.688,9,7,2,0,.778,7,4,3,0,.571,16,3300,,2017002,2017:3300,2017,2017
543,1050,NFL,1050,Cleveland Browns,Cleveland Browns,CLE,8808,16,0,16,0,.000,3,0,3,0,.000,13,0,13,0,.000,16,1050,,2017002,2017:1050,2017,2017
543,325,NFL,325,Baltimore Ravens,Baltimore Ravens,BAL,8803,16,9,7,0,.563,9,8,1,0,.889,7,1,6,0,.143,16,325,,2017002,2017:325,2017,2017
543,2510,NFL,2510,Los Angeles Rams,Los Angeles Rams,LA,8828,16,11,5,0,.688,13,10,3,0,.769,3,1,2,0,.333,16,2510,,2017002,2017:2510,2017,2017
543,3900,NFL,3900,Pittsburgh Steelers,Pittsburgh Steelers,PIT,8824,16,13,3,0,.813,12,11,1,0,.917,4,2,2,0,.500,16,3900,,2017002,2017:3900,2017,2017
543,810,NFL,810,Chicago Bears,Chicago Bears,CHI,8806,16,5,11,0,.313,7,5,2,0,.714,9,0,9,0,.000,16,810,,2017002,2017:810,2017,2017
543,2100,NFL,2100,Tennessee Titans,Tennessee Titans,TEN,8830,16,9,7,0,.563,8,7,1,0,.875,8,2,6,0,.250,16,2100,,2017002,2017:2100,2017,2017
543,5110,NFL,5110,Washington Football Team,Washington Football Team,WAS,8831,16,7,9,0,.438,9,4,5,0,.444,7,3,4,0,.429,16,5110,,2017002,2017:5110,2017,2017
543,4600,NFL,4600,Seattle Seahawks,Seattle Seahawks,SEA,8827,16,9,7,0,.563,7,5,2,0,.714,9,4,5,0,.444,16,4600,,2017002,2017:4600,2017,2017
543,4500,NFL,4500,San Francisco 49ers,San Francisco 49ers,SF,8826,16,6,10,0,.375,6,5,1,0,.833,10,1,9,0,.100,16,4500,,2017002,2017:4500,2017,2017
543,3800,NFL,3800,Arizona Cardinals,Arizona Cardinals,ARI,8801,16,8,8,0,.500,7,5,2,0,.714,9,3,6,0,.333,16,3800,,2017002,2017:3800,2017,2017
543,2250,NFL,2250,Jacksonville Jaguars,Jacksonville Jaguars,JAX,8814,16,10,6,0,.625,11,9,2,0,.818,5,1,4,0,.200,16,2250,,2017002,2017:2250,2017,2017
543,2120,NFL,2120,Houston Texans,Houston Texans,HOU,13974,16,4,12,0,.250,9,4,5,0,.444,7,0,7,0,.000,16,2120,,2017002,2017:2120,2017,2017
543,1400,NFL,1400,Denver Broncos,Denver Broncos,DEN,8810,16,5,11,0,.313,7,4,3,0,.571,9,1,8,0,.111,16,1400,,2017002,2017:1400,2017,2017
543,2520,NFL,2520,Oakland Raiders,Oakland Raiders,OAK,8822,16,6,10,0,.375,7,5,2,0,.714,9,1,8,0,.111,16,2520,,2017002,2017:2520,2017,2017
543,200,NFL,200,Atlanta Falcons,Atlanta Falcons,ATL,8802,16,10,6,0,.625,10,6,4,0,.600,6,4,2,0,.667,16,200,,2017002,2017:200,2017,2017
543,3700,NFL,3700,Philadelphia Eagles,Philadelphia Eagles,PHI,8823,16,13,3,0,.813,8,8,0,0,1.000,8,5,3,0,.625,16,3700,,2017002,2017:3700,2017,2017
543,1200,NFL,1200,Dallas Cowboys,Dallas Cowboys,DAL,8809,16,9,7,0,.563,12,7,5,0,.583,4,2,2,0,.500,16,1200,,2017002,2017:1200,2017,2017
543,3410,NFL,3410,New York Giants,New York Giants,NYG,8820,16,3,13,0,.188,7,3,4,0,.429,9,0,9,0,.000,16,3410,,2017002,2017:3410,2017,2017
543,3200,NFL,3200,New England Patriots,New England Patriots,NE,8818,16,13,3,0,.813,12,10,2,0,.833,4,3,1,0,.750,16,3200,,2017002,2017:3200,2017,2017
543,3430,NFL,3430,New York Jets,New York Jets,NYJ,8821,16,5,11,0,.313,6,3,3,0,.500,10,2,8,0,.200,16,3430,,2017002,2017:3430,2017,2017
543,4400,NFL,4400,Los Angeles Chargers,Los Angeles Chargers,LAC,8825,16,9,7,0,.563,8,7,1,0,.875,8,2,6,0,.250,16,4400,,2017002,2017:4400,2017,2017
543,1540,NFL,1540,Detroit Lions,Detroit Lions,DET,8811,16,9,7,0,.563,7,5,2,0,.714,9,4,5,0,.444,16,1540,,2017002,2017:1540,2017,2017
543,3000,NFL,3000,Minnesota Vikings,Minnesota Vikings,MIN,8817,16,13,3,0,.813,6,6,0,0,1.000,10,7,3,0,.700,16,3000,,2017002,2017:3000,2017,2017
543,920,NFL,920,Cincinnati Bengals,Cincinnati Bengals,CIN,8807,16,7,9,0,.438,7,5,2,0,.714,9,2,7,0,.222,16,920,,2017002,2017:920,2017,2017
543,750,NFL,750,Carolina Panthers,Carolina Panthers,CAR,8805,16,11,5,0,.688,9,8,1,0,.889,7,3,4,0,.429,16,750,,2017002,2017:750,2017,2017
543,2700,NFL,2700,Miami Dolphins,Miami Dolphins,MIA,8816,16,6,10,0,.375,4,4,0,0,1.000,12,2,10,0,.167,16,2700,,2017002,2017:2700,2017,2017
575,610,NFL,610,Buffalo Bills,Buffalo Bills,BUF,8804,16,6,10,0,.375,6,5,1,0,.833,10,1,9,0,.100,16,610,,2018002,2018:610,2018,2018
575,2200,NFL,2200,Indianapolis Colts,Indianapolis Colts,IND,8813,16,10,6,0,.625,8,7,1,0,.875,8,3,5,0,.375,16,2200,,2018002,2018:2200,2018,2018
575,2310,NFL,2310,Kansas City Chiefs,Kansas City Chiefs,KC,8815,16,12,4,0,.750,12,10,2,0,.833,4,2,2,0,.500,16,2310,,2018002,2018:2310,2018,2018
575,4900,NFL,4900,Tampa Bay Buccaneers,Tampa Bay Buccaneers,TB,8829,16,5,11,0,.313,9,3,6,0,.333,7,2,5,0,.286,16,4900,,2018002,2018:4900,2018,2018
575,1800,NFL,1800,Green Bay Packers,Green Bay Packers,GB,8812,16,6,9,1,.406,7,2,4,1,.357,9,4,5,0,.444,16,1800,,2018002,2018:1800,2018,2018
575,3300,NFL,3300,New Orleans Saints,New Orleans Saints,NO,8819,16,13,3,0,.813,8,7,1,0,.875,8,6,2,0,.750,16,3300,,2018002,2018:3300,2018,2018
575,1050,NFL,1050,Cleveland Browns,Cleveland Browns,CLE,8808,16,7,8,1,.469,7,4,3,0,.571,9,3,5,1,.389,16,1050,,2018002,2018:1050,2018,2018
575,325,NFL,325,Baltimore Ravens,Baltimore Ravens,BAL,8803,16,10,6,0,.625,10,6,4,0,.600,6,4,2,0,.667,16,325,,2018002,2018:325,2018,2018
575,2510,NFL,2510,Los Angeles Rams,Los Angeles Rams,LA,8828,16,13,3,0,.813,8,7,1,0,.875,8,6,2,0,.750,16,2510,,2018002,2018:2510,2018,2018
575,3900,NFL,3900,Pittsburgh Steelers,Pittsburgh Steelers,PIT,8824,16,9,6,1,.594,5,2,2,1,.500,11,7,4,0,.636,16,3900,,2018002,2018:3900,2018,2018
575,810,NFL,810,Chicago Bears,Chicago Bears,CHI,8806,16,12,4,0,.750,9,8,1,0,.889,7,4,3,0,.571,16,810,,2018002,2018:810,2018,2018
575,2100,NFL,2100,Tennessee Titans,Tennessee Titans,TEN,8830,16,9,7,0,.563,9,6,3,0,.667,7,3,4,0,.429,16,2100,,2018002,2018:2100,2018,2018
575,5110,NFL,5110,Washington Football Team,Washington Football Team,WAS,8831,16,7,9,0,.438,8,7,1,0,.875,8,0,8,0,.000,16,5110,,2018002,2018:5110,2018,2018
575,4600,NFL,4600,Seattle Seahawks,Seattle Seahawks,SEA,8827,16,10,6,0,.625,11,6,5,0,.545,5,4,1,0,.800,16,4600,,2018002,2018:4600,2018,2018
575,4500,NFL,4500,San Francisco 49ers,San Francisco 49ers,SF,8826,16,4,12,0,.250,8,2,6,0,.250,8,2,6,0,.250,16,4500,,2018002,2018:4500,2018,2018
575,3800,NFL,3800,Arizona Cardinals,Arizona Cardinals,ARI,8801,16,3,13,0,.188,6,0,6,0,.000,10,3,7,0,.300,16,3800,,2018002,2018:3800,2018,2018
575,2250,NFL,2250,Jacksonville Jaguars,Jacksonville Jaguars,JAX,8814,16,5,11,0,.313,7,4,3,0,.571,9,1,8,0,.111,16,2250,,2018002,2018:2250,2018,2018
575,2120,NFL,2120,Houston Texans,Houston Texans,HOU,13974,16,11,5,0,.688,8,6,2,0,.750,8,5,3,0,.625,16,2120,,2018002,2018:2120,2018,2018
575,1400,NFL,1400,Denver Broncos,Denver Broncos,DEN,8810,16,6,10,0,.375,7,3,4,0,.429,9,3,6,0,.333,16,1400,,2018002,2018:1400,2018,2018
575,2520,NFL,2520,Oakland Raiders,Oakland Raiders,OAK,8822,16,4,12,0,.250,10,4,6,0,.400,6,0,6,0,.000,16,2520,,2018002,2018:2520,2018,2018
575,200,NFL,200,Atlanta Falcons,Atlanta Falcons,ATL,8802,16,7,9,0,.438,6,2,4,0,.333,10,5,5,0,.500,16,200,,2018002,2018:200,2018,2018
575,3700,NFL,3700,Philadelphia Eagles,Philadelphia Eagles,PHI,8823,16,9,7,0,.563,7,6,1,0,.857,9,3,6,0,.333,16,3700,,2018002,2018:3700,2018,2018
575,1200,NFL,1200,Dallas Cowboys,Dallas Cowboys,DAL,8809,16,10,6,0,.625,11,9,2,0,.818,5,1,4,0,.200,16,1200,,2018002,2018:1200,2018,2018
575,3410,NFL,3410,New York Giants,New York Giants,NYG,8820,16,5,11,0,.313,7,3,4,0,.429,9,2,7,0,.222,16,3410,,2018002,2018:3410,2018,2018
575,3200,NFL,3200,New England Patriots,New England Patriots,NE,8818,16,11,5,0,.688,10,9,1,0,.900,6,2,4,0,.333,16,3200,,2018002,2018:3200,2018,2018
575,3430,NFL,3430,New York Jets,New York Jets,NYJ,8821,16,4,12,0,.250,5,1,4,0,.200,11,3,8,0,.273,16,3430,,2018002,2018:3430,2018,2018
575,4400,NFL,4400,Los Angeles Chargers,Los Angeles Chargers,LAC,8825,16,12,4,0,.750,6,5,1,0,.833,10,7,3,0,.700,16,4400,,2018002,2018:4400,2018,2018
575,1540,NFL,1540,Detroit Lions,Detroit Lions,DET,8811,16,6,10,0,.375,10,5,5,0,.500,6,1,5,0,.167,16,1540,,2018002,2018:1540,2018,2018
575,3000,NFL,3000,Minnesota Vikings,Minnesota Vikings,MIN,8817,16,8,7,1,.531,6,5,1,0,.833,10,3,6,1,.350,16,3000,,2018002,2018:3000,2018,2018
575,920,NFL,920,Cincinnati Bengals,Cincinnati Bengals,CIN,8807,16,6,10,0,.375,7,4,3,0,.571,9,2,7,0,.222,16,920,,2018002,2018:920,2018,2018
575,750,NFL,750,Carolina Panthers,Carolina Panthers,CAR,8805,16,7,9,0,.438,10,3,7,0,.300,6,4,2,0,.667,16,750,,2018002,2018:750,2018,2018
575,2700,NFL,2700,Miami Dolphins,Miami Dolphins,MIA,8816,16,7,9,0,.438,8,4,4,0,.500,8,3,5,0,.375,16,2700,,2018002,2018:2700,2018,2018
607,610,NFL,610,Buffalo Bills,Buffalo Bills,BUF,8804,16,10,6,0,.625,8,7,1,0,.875,8,3,5,0,.375,16,610,,2019002,2019:610,2019,2019
607,2200,NFL,2200,Indianapolis Colts,Indianapolis Colts,IND,8813,16,7,9,0,.438,8,4,4,0,.500,8,3,5,0,.375,16,2200,,2019002,2019:2200,2019,2019
607,2310,NFL,2310,Kansas City Chiefs,Kansas City Chiefs,KC,8815,16,12,4,0,.750,9,6,3,0,.667,7,6,1,0,.857,16,2310,,2019002,2019:2310,2019,2019
607,4900,NFL,4900,Tampa Bay Buccaneers,Tampa Bay Buccaneers,TB,8829,16,7,9,0,.438,7,4,3,0,.571,9,3,6,0,.333,16,4900,,2019002,2019:4900,2019,2019
607,1800,NFL,1800,Green Bay Packers,Green Bay Packers,GB,8812,16,13,3,0,.813,8,7,1,0,.875,8,6,2,0,.750,16,1800,,2019002,2019:1800,2019,2019
607,3300,NFL,3300,New Orleans Saints,New Orleans Saints,NO,8819,16,13,3,0,.813,10,9,1,0,.900,6,4,2,0,.667,16,3300,,2019002,2019:3300,2019,2019
607,1050,NFL,1050,Cleveland Browns,Cleveland Browns,CLE,8808,16,6,10,0,.375,10,5,5,0,.500,6,1,5,0,.167,16,1050,,2019002,2019:1050,2019,2019
607,325,NFL,325,Baltimore Ravens,Baltimore Ravens,BAL,8803,16,14,2,0,.875,12,11,1,0,.917,4,3,1,0,.750,16,325,,2019002,2019:325,2019,2019
607,2510,NFL,2510,Los Angeles Rams,Los Angeles Rams,LA,8828,16,9,7,0,.563,11,7,4,0,.636,5,2,3,0,.400,16,2510,,2019002,2019:2510,2019,2019
607,3900,NFL,3900,Pittsburgh Steelers,Pittsburgh Steelers,PIT,8824,16,8,8,0,.500,5,3,2,0,.600,11,5,6,0,.455,16,3900,,2019002,2019:3900,2019,2019
607,810,NFL,810,Chicago Bears,Chicago Bears,CHI,8806,16,8,8,0,.500,6,4,2,0,.667,10,4,6,0,.400,16,810,,2019002,2019:810,2019,2019
607,2100,NFL,2100,Tennessee Titans,Tennessee Titans,TEN,8830,16,9,7,0,.563,4,3,1,0,.750,12,6,6,0,.500,16,2100,,2019002,2019:2100,2019,2019
607,5110,NFL,5110,Washington Football Team,Washington Football Team,WAS,8831,16,3,13,0,.188,5,2,3,0,.400,11,1,10,0,.091,16,5110,,2019002,2019:5110,2019,2019
607,4600,NFL,4600,Seattle Seahawks,Seattle Seahawks,SEA,8827,16,11,5,0,.688,5,3,2,0,.600,11,8,3,0,.727,16,4600,,2019002,2019:4600,2019,2019
607,4500,NFL,4500,San Francisco 49ers,San Francisco 49ers,SF,8826,16,13,3,0,.813,10,7,3,0,.700,6,6,0,0,1.000,16,4500,,2019002,2019:4500,2019,2019
607,3800,NFL,3800,Arizona Cardinals,Arizona Cardinals,ARI,8801,16,5,10,1,.344,7,2,5,0,.286,9,3,5,1,.389,16,3800,,2019002,2019:3800,2019,2019
607,2250,NFL,2250,Jacksonville Jaguars,Jacksonville Jaguars,JAX,8814,16,6,10,0,.375,5,3,2,0,.600,11,3,8,0,.273,16,2250,,2019002,2019:2250,2019,2019
607,2120,NFL,2120,Houston Texans,Houston Texans,HOU,13974,16,10,6,0,.625,7,5,2,0,.714,9,5,4,0,.556,16,2120,,2019002,2019:2120,2019,2019
607,1400,NFL,1400,Denver Broncos,Denver Broncos,DEN,8810,16,7,9,0,.438,10,5,5,0,.500,6,2,4,0,.333,16,1400,,2019002,2019:1400,2019,2019
607,2520,NFL,2520,Oakland Raiders,Oakland Raiders,OAK,8822,16,7,9,0,.438,13,6,7,0,.462,3,1,2,0,.333,16,2520,,2019002,2019:2520,2019,2019
607,200,NFL,200,Atlanta Falcons,Atlanta Falcons,ATL,8802,16,7,9,0,.438,10,6,4,0,.600,6,1,5,0,.167,16,200,,2019002,2019:200,2019,2019
607,3700,NFL,3700,Philadelphia Eagles,Philadelphia Eagles,PHI,8823,16,9,7,0,.563,10,6,4,0,.600,6,3,3,0,.500,16,3700,,2019002,2019:3700,2019,2019
607,1200,NFL,1200,Dallas Cowboys,Dallas Cowboys,DAL,8809,16,8,8,0,.500,7,4,3,0,.571,9,4,5,0,.444,16,1200,,2019002,2019:1200,2019,2019
607,3410,NFL,3410,New York Giants,New York Giants,NYG,8820,16,4,12,0,.250,7,2,5,0,.286,9,2,7,0,.222,16,3410,,2019002,2019:3410,2019,2019
607,3200,NFL,3200,New England Patriots,New England Patriots,NE,8818,16,12,4,0,.750,11,9,2,0,.818,5,3,2,0,.600,16,3200,,2019002,2019:3200,2019,2019
607,3430,NFL,3430,New York Jets,New York Jets,NYJ,8821,16,7,9,0,.438,8,5,3,0,.625,8,2,6,0,.250,16,3430,,2019002,2019:3430,2019,2019
607,4400,NFL,4400,Los Angeles Chargers,Los Angeles Chargers,LAC,8825,16,5,11,0,.313,6,3,3,0,.500,10,2,8,0,.200,16,4400,,2019002,2019:4400,2019,2019
607,1540,NFL,1540,Detroit Lions,Detroit Lions,DET,8811,16,3,12,1,.219,9,1,7,1,.167,7,2,5,0,.286,16,1540,,2019002,2019:1540,2019,2019
607,3000,NFL,3000,Minnesota Vikings,Minnesota Vikings,MIN,8817,16,10,6,0,.625,10,8,2,0,.800,6,2,4,0,.333,16,3000,,2019002,2019:3000,2019,2019
607,920,NFL,920,Cincinnati Bengals,Cincinnati Bengals,CIN,8807,16,2,14,0,.125,6,0,6,0,.000,10,2,8,0,.200,16,920,,2019002,2019:920,2019,2019
607,750,NFL,750,Carolina Panthers,Carolina Panthers,CAR,8805,16,5,11,0,.313,6,4,2,0,.667,10,1,9,0,.100,16,750,,2019002,2019:750,2019,2019
607,2700,NFL,2700,Miami Dolphins,Miami Dolphins,MIA,8816,16,5,11,0,.313,6,3,3,0,.500,10,2,8,0,.200,16,2700,,2019002,2019:2700,2019,2019
639,610,NFL,610,Buffalo Bills,Buffalo Bills,BUF,8804,16,13,3,0,.813,9,8,1,0,.889,7,5,2,0,.714,16,610,,2020002,2020:610,2020,2020
639,2200,NFL,2200,Indianapolis Colts,Indianapolis Colts,IND,8813,16,11,5,0,.688,9,6,3,0,.667,7,5,2,0,.714,16,2200,,2020002,2020:2200,2020,2020
639,2310,NFL,2310,Kansas City Chiefs,Kansas City Chiefs,KC,8815,16,14,2,0,.875,6,5,1,0,.833,10,9,1,0,.900,16,2310,,2020002,2020:2310,2020,2020
639,4900,NFL,4900,Tampa Bay Buccaneers,Tampa Bay Buccaneers,TB,8829,16,11,5,0,.688,8,6,2,0,.750,8,5,3,0,.625,16,4900,,2020002,2020:4900,2020,2020
639,1800,NFL,1800,Green Bay Packers,Green Bay Packers,GB,8812,16,13,3,0,.813,11,8,3,0,.727,5,5,0,0,1.000,16,1800,,2020002,2020:1800,2020,2020
639,3300,NFL,3300,New Orleans Saints,New Orleans Saints,NO,8819,16,12,4,0,.750,8,7,1,0,.875,8,5,3,0,.625,16,3300,,2020002,2020:3300,2020,2020
639,1050,NFL,1050,Cleveland Browns,Cleveland Browns,CLE,8808,16,11,5,0,.688,9,6,3,0,.667,7,5,2,0,.714,16,1050,,2020002,2020:1050,2020,2020
639,325,NFL,325,Baltimore Ravens,Baltimore Ravens,BAL,8803,16,11,5,0,.688,10,8,2,0,.800,6,3,3,0,.500,16,325,,2020002,2020:325,2020,2020
639,2510,NFL,2510,Los Angeles Rams,Los Angeles Rams,LA,8828,16,10,6,0,.625,11,8,3,0,.727,5,2,3,0,.400,16,2510,,2020002,2020:2510,2020,2020
639,3900,NFL,3900,Pittsburgh Steelers,Pittsburgh Steelers,PIT,8824,16,12,4,0,.750,10,8,2,0,.800,6,4,2,0,.667,16,3900,,2020002,2020:3900,2020,2020
639,810,NFL,810,Chicago Bears,Chicago Bears,CHI,8806,16,8,8,0,.500,6,4,2,0,.667,10,4,6,0,.400,16,810,,2020002,2020:810,2020,2020
639,2100,NFL,2100,Tennessee Titans,Tennessee Titans,TEN,8830,16,11,5,0,.688,11,10,1,0,.909,5,1,4,0,.200,16,2100,,2020002,2020:2100,2020,2020
639,5110,NFL,5110,Washington Football Team,Washington Football Team,WAS,8831,16,7,9,0,.438,4,3,1,0,.750,12,4,8,0,.333,16,5110,,2020002,2020:5110,2020,2020
639,4600,NFL,4600,Seattle Seahawks,Seattle Seahawks,SEA,8827,16,12,4,0,.750,8,6,2,0,.750,8,6,2,0,.750,16,4600,,2020002,2020:4600,2020,2020
639,4500,NFL,4500,San Francisco 49ers,San Francisco 49ers,SF,8826,16,6,10,0,.375,8,4,4,0,.500,8,2,6,0,.250,16,4500,,2020002,2020:4500,2020,2020
639,3800,NFL,3800,Arizona Cardinals,Arizona Cardinals,ARI,8801,16,8,8,0,.500,10,6,4,0,.600,6,2,4,0,.333,16,3800,,2020002,2020:3800,2020,2020
639,2250,NFL,2250,Jacksonville Jaguars,Jacksonville Jaguars,JAX,8814,16,1,15,0,.063,6,0,6,0,.000,10,1,9,0,.100,16,2250,,2020002,2020:2250,2020,2020
639,2120,NFL,2120,Houston Texans,Houston Texans,HOU,13974,16,4,12,0,.250,2,1,1,0,.500,14,3,11,0,.214,16,2120,,2020002,2020:2120,2020,2020
639,1400,NFL,1400,Denver Broncos,Denver Broncos,DEN,8810,16,5,11,0,.313,6,3,3,0,.500,10,2,8,0,.200,16,1400,,2020002,2020:1400,2020,2020
639,2520,NFL,2520,Las Vegas Raiders,Las Vegas Raiders,LV,8822,16,8,8,0,.500,7,3,4,0,.429,9,5,4,0,.556,16,2520,,2020002,2020:2520,2020,2020
639,200,NFL,200,Atlanta Falcons,Atlanta Falcons,ATL,8802,16,4,12,0,.250,11,4,7,0,.364,5,0,5,0,.000,16,200,,2020002,2020:200,2020,2020
639,3700,NFL,3700,Philadelphia Eagles,Philadelphia Eagles,PHI,8823,16,4,11,1,.281,7,3,3,1,.500,9,1,8,0,.111,16,3700,,2020002,2020:3700,2020,2020
639,1200,NFL,1200,Dallas Cowboys,Dallas Cowboys,DAL,8809,16,6,10,0,.375,9,4,5,0,.444,7,2,5,0,.286,16,1200,,2020002,2020:1200,2020,2020
639,3410,NFL,3410,New York Giants,New York Giants,NYG,8820,16,6,10,0,.375,7,5,2,0,.714,9,1,8,0,.111,16,3410,,2020002,2020:3410,2020,2020
639,3200,NFL,3200,New England Patriots,New England Patriots,NE,8818,16,7,9,0,.438,7,3,4,0,.429,9,4,5,0,.444,16,3200,,2020002,2020:3200,2020,2020
639,3430,NFL,3430,New York Jets,New York Jets,NYJ,8821,16,2,14,0,.125,8,1,7,0,.125,8,1,7,0,.125,16,3430,,2020002,2020:3430,2020,2020
639,4400,NFL,4400,Los Angeles Chargers,Los Angeles Chargers,LAC,8825,16,7,9,0,.438,6,4,2,0,.667,10,3,7,0,.300,16,4400,,2020002,2020:4400,2020,2020
639,1540,NFL,1540,Detroit Lions,Detroit Lions,DET,8811,16,5,11,0,.313,11,4,7,0,.364,5,1,4,0,.200,16,1540,,2020002,2020:1540,2020,2020
639,3000,NFL,3000,Minnesota Vikings,Minnesota Vikings,MIN,8817,16,7,9,0,.438,7,4,3,0,.571,9,3,6,0,.333,16,3000,,2020002,2020:3000,2020,2020
639,920,NFL,920,Cincinnati Bengals,Cincinnati Bengals,CIN,8807,16,4,11,1,.281,9,4,5,0,.444,7,0,6,1,.071,16,920,,2020002,2020:920,2020,2020
639,750,NFL,750,Carolina Panthers,Carolina Panthers,CAR,8805,16,5,11,0,.313,7,4,3,0,.571,9,1,8,0,.111,16,750,,2020002,2020:750,2020,2020
639,2700,NFL,2700,Miami Dolphins,Miami Dolphins,MIA,8816,16,10,6,0,.625,8,5,3,0,.625,8,5,3,0,.625,16,2700,,2020002,2020:2700,2020,2020
